----------------
----------------
----------------
----------------
----------------
----------------
----------------
----------------
----------------
----------------
----------------
--------------Q-
----------------
----------------
----------------
XXXXXXXXXXXXXXXX
