----------------
----------------
----------------
----------------
----------------
----------------
----------------
--------XX------
-------XXX------
------XXXX------
-----XXXXX------
----XXXXXX------
---XXXXXXX------
>-XXXXXXXX------
]XXXXXXXXX------
XXXXXXXXXXXXXXXX
