----------------
----------------
----------------
----------------
----------------
----------------
----------------
----------------
----------------
----------------
----------------
--------<>------
<>------[]------
[]------[]------
[]-E----[]-----E
XXXXXXXXXXXXXXXX
