----------------
----------------
----------------
----------------
----------------
----------------
----------------
-SQQS-----------
----------------
----------------
----------------
--SS------X--X--
---------XX--XX-
--------XXX--XXX
E-E----XXXX--XXX
XXXXXXXXXXXXXXXX
