----------------
----------------
----------------
----------------
----------------
----------------
----------------
----------------
SSS-------------
X---------------
S--------------o
X------------E--
X-SSS-------<>--
X-----------[]--
X-----------[]--
XXX---XXXXXXXXXX
