----------------
----------------
----------------
----------------
----------------
----------------
----------------
----------------
----------------
----------------
----------------
----------------
----------------
----------------
--EE-E--E-------
XXXXXXXXXXXXXXXX
