----------------
----------------
----------------
----------------
----------------
----------------
----------------
-----------SSQSS
----------------
----------------
----E-----------
---<>------SSSSS
----------------
----------------
----------------
XXXXXXXXXXXXXXXX
