----------------
----------------
----------------
----------------
----------------
----------------
---E------------
SSSSS----S------
----------------
----------------
E---------------
SSSSS-----E-----
---------<>-----
---------[]-----
---------[]-----
XXXXXXXXXXXXXXXX
