----------------
----------------
----------------
----------------
----------------
----------------
----------------
-SSS------------
----------------
----------------
----------------
XXXXX-----------
X---------------
X---------------
X-------------EE
XXX----XXXXXXXXX
