----------------
----------------
----------------
----------------
----------------
----------------
----------------
---SSS----------
----------------
----------------
----------------
-XX-------------
-XX-------------
-XXX------------
-XXX--E-E---E---
-XXXXXXXXXXXXXXX
