----------------
----------------
----------------
----------------
SSSSSSSSSSSSSSSS
----------------
----------------
----------------
----------o-----
----------------
---------S------
---XXXX---------
-XXXXXXXX--XX---
XXXXXXXXX--XXXX-
XXXXXXXXXE-XXXX-
XXXXXXXXXXXXXXXX
