----------------
----------------
----------------
----------------
----------------
----------------
----------------
o--XXXX---------
----------------
------------XXX-
----------------
-XX---XXXXX-----
----------------
----------------
----------------
---XXXX---------
