----------------
----------------
----------------
----------------
SSSSSSSSSSSSSSSS
SSSSSSSSSSSSSSSS
SSSSSSSSSSSSSSSS
SSSSSSSSSSSSSSSS
----------------
----------------
--------?-------
--SSSSSS??SSSSSS
--SSSSS---SSSSSS
--SSSSS---SSSSSS
-------oooSSSSSS
-XXXXXXXXXXXXXXX
