----------------
----------------
----------------
----------------
----------------
----------------
----------------
-------S--------
----------------
----------------
----------------
-----QQQQ-------
----------------
----------------
----------------
XXXXXXXXXXXXXXXX
