----------------
----------------
----------------
----------------
----------------
----------------
----------------
--S-------SSS---
----------------
----------------
-E-EE-----------
-----XX-XX------
-----XX-XX------
-----XX-XXX-----
-----X--XXX--E-E
-----X--XXXXXXXX
