----------------
----------------
----------------
----------------
----------------
----------------
----------------
----------------
----------------
----------------
----------------
----------------
----------------
----------------
E-----E----EE-E-
XXXXXXXXXXXXXXXX
