----------------
----------------
----------------
----------------
----------------
----------------
----------------
----------------
----------------
-------XX-------
------XXX-------
-----XXXX-------
----XXXXX-------
---XXXXXX-------
--XXXXXXX-----E-
XXXXXXXX--XXXXXX
