----------------
----------------
----------------
----------------
----------------
----------------
----------------
----------------
------XXX-------
----------------
----------------
XXXX------------
----------------
----------------
------------E---
-------XXXXXXXXX
