----------------
----------------
----------------
----------------
SSSSSSSSS?SSSSSS
----------------
----------------
----oooooo------
----------------
----SSSSSS------
----SSSSSS------
----------------
----------------
----------------
----------------
---XXXXXXXXXXXXX
