----------------
----------------
----------------
----------------
----------------
----------------
----------------
S---?-----------
----------------
----------------
----------------
---------E------
--E-----<>------
--------[]------
--------[]E-----
XXXXXXXXXXXXXXXX
