----------------
----------------
----------------
----------------
----------------
----------------
----------------
----------------
----------------
----------------
----------------
--------E-------
-------<>-----E-
-------[]----<>-
-------[]-E--[]-
XXXXXXXXXXXXXXXX
