----------------
----------------
----------------
----------------
----------------
----------------
----------------
---------SSS----
----------------
----------------
----------------
---E----XXXXX---
---E----X-------
--------X-------
--------X-------
XXXXXXXXXXX----X
