----------------
----------------
----------------
----------------
SSSSSSSSSSSSSSSS
SSSSSSS---------
SSSSSSS---------
SSSSSSS--QQ-----
----------------
----------------
-E-EE-----------
SSSSSSS--QQ--QQQ
SSSSSSS---------
SSSSSSS---------
SSSSSSS---------
XXXXXXXXXXXXXXXX
