----------------
----------------
----------------
----------------
----------------
----------------
----------------
----------------
----------------
---------------E
-----E--------<>
----<>---SS---[]
----[]--------[]
----[]--------[]
----[]--------[]
XXXXXXXXXXXXXXXX
