----------------
----------------
----------------
----------------
----------------
----------------
----------------
---XX-----------
---XX-----------
-XXXX-----------
-XXXX-----------
XXXXX-----------
XXXXX-----------
XXXXX-----------
XXXXX--------X--
XXXXXXXXXXXXXXXX
