----------------
----------------
----------------
----------------
----------------
----------------
----------------
-------SS-------
----------------
---------------o
----------------
------XXXX--SSS-
---XXXXX--------
XXXXXX----------
XXXX------------
XX------XX--XXXX
