----------------
----------------
----------------
----------------
----------------
----------------
----------------
------SSSSSSSS--
----------------
----------------
----------------
-----X----S----X
-----X------E--X
-----X---------X
-EE--X---------X
XXXXXXXXXXXXXXXX
