----------------
----------------
----------------
----------------
----------------
----------------
----------------
----------------
----------------
----------------
-----oo---------
----o--o--------
----------------
----------------
----------------
XXXXXXXXXXXXXXXX
