----------------
----------------
----------------
----------------
----------------
----------------
-------E--------
---SSSSSS----S--
----------------
----------------
----E-----------
--SSSSSSS-----E-
-------------<>-
-------------[]-
-------------[]-
XXXXXXXXXXXXXXXX
