----------------
----------------
----------------
----------------
----------------
----------------
----------------
----------------
----------------
----------------
--S--------o----
-----E----------
----<>----------
----[]----------
----[]----------
XXXXXXXXXXXXXXXX
