----------------
----------------
----------------
----------------
----------------
----------------
----------------
-------------S--
----------------
----------------
----------------
----E-------SS--
---<>-----------
---[]-----------
---[]E----------
XXXXXXXXXXXXXXXX
