----------------
----------------
----------------
----------------
----------------
----------------
----------------
SSSSSS----------
----------------
----------------
----------------
----------------
----------E---E-
---------<>--<>-
---------[]--[]-
X------XXXXXXXXX
