----------------
----------------
----------------
----------------
----------------
----------------
----------------
---------QQQQ---
----------------
----------------
----------------
-------QQ?SSQQQ-
----------------
----------------
----------------
XXXXXXXXXX--XXXX
