----------------
----------------
----------------
----------------
----oo----------
--------E--E----
-------XXXXXXX--
----------------
----------------
----------------
--XXXXX---------
----------------
----------------
o---------------
XX--------------
----------------
