----------------
----------------
----------------
--------XXX-----
SSSSSSS-----SSSS
------------SSSS
------------SSSS
------------SSSS
------------S---
------------S---
-------------?oo
-------------??S
------XX--------
-----XXXXXX-----
----XXXX--------
XXXXXXX-----XXXX
