----------------
----------------
----------------
----------------
----------------
----------------
----------------
----SSSSS---?---
----------------
----------------
----------------
-S---E----------
----------E-----
----------------
EE--------------
XXXXXXXXXXXXXXXX
