----------------
----------------
----------------
----------------
----------------
----------------
oo--------------
----------------
---------E------
-------XXXXXXXX-
----------------
----------------
----------------
-XXXX-----------
----------------
----------------
