----------------
----------------
----------------
----------------
----------------
----------------
----------------
------E-----oo--
----------------
XXXX------------
----------------
--------XXXX--XX
----------------
----------------
-----ooo--------
-----XXX--------
