----------------
----------------
----------------
----------------
----------------
----------------
----------------
----------------
----------------
----------------
----------------
----------SSXSS-
E---------------
----------------
----------------
XXXXXXXXXXXXXXXX
