----------------
----------------
----------------
----------------
----------------
----------------
----------------
----------------
----------------
----------------
----------------
--X--X----------
-XX--XX--------X
XXX--XXX------XX
XXX--XXXX----XXX
XXXXXXXXXXXXXXXX
