----------------
----------------
----------------
----------------
----------------
----------------
-----------oo---
----------------
----------------
----------------
o------E--------
------<>--------
------[]--------
------[]--------
------[]-E-EE---
XXXXXXXXXXXXXXXX
