----------------
----------------
----------------
----------------
----------------
----------------
----------------
SSSSS------SSSS-
----------------
----------------
----------------
QQ--QQQ---------
----------------
----------------
--E-EE----------
XXXXXXXXXXX----X
