----------------
----------------
----------------
----------------
----------------
----------------
----------------
SSSS---SSSQ-----
----------------
----------------
----------------
----------S-----
----------------
----------------
-----------E-E--
XX---XXXXXXXXXXX
