----------------
----------------
----------------
----------------
----------------
----------------
----------------
----------------
----------------
----------------
----------------
-S--------------
--------E------X
-------<>-----XX
E------------XXX
XXXXXXXXXXXXXXXX
