----------------
----------------
----------------
----------------
----------------
----------------
----------------
-XXXX-----------
--------------XX
----------XXX-oo
----------------
X---XXXXX-------
----------------
----------------
----------------
-XXXX-----------
