----------------
----------------
----------------
----------------
----------------
----------------
----------------
SSSS------------
----------------
----------------
------------E---
-----------<>---
-----------[]---
-----------[]---
--------E--[]---
----XXXXXXXXXX--
