----------------
----------------
----------------
----------------
----------------
----------------
----------------
----------------
----------------
----------------
----------------
----------------
---------E----E-
----------------
---------------X
XXXXXXXXXXXXXXXX
