----------------
----------------
----------------
----------------
----------------
----------------
----------------
-----E--S---SSSS
----<>----------
----[]----------
----[]----------
---SXXS---------
---------E------
--------<>------
--------[]------
XXXXXXXXXXXXXXXX
