----------------
----------------
----------------
----------------
----------------
----------------
----------------
---------------?
----------------
----------------
----------------
----------------
------------E---
----------------
----------------
XXXXXXXXXXXXXXXX
