----------------
----------------
----------------
----------------
SSSSSSSSSSSSSSSS
----------------
----------------
-----------oooo-
o---------------
---------S-SSSS-
---------SoS--So
---------SSS--SS
-XX-------------
-XXXX-----------
-XXXX-------EE--
XXXXXXXXXXXXXXXX
