----------------
----------------
----------------
----------------
----------------
----------------
----------------
-----SSSS-------
----------------
----------------
-----------E----
----S-----<>---Q
----------[]----
----------[]----
E--EE-E---[]----
XXXXXXXXXXXXXXXX
