----------------
----------------
----------------
----------------
----------------
----------------
----------------
----------------
----------------
----------------
--E-------------
-<>-------------
----------------
----------------
E-------------EE
XXXXXXXX---XXXXX
