----------------
----------------
----------------
----------------
SSSSSSSSSSSSSSSS
----------------
----------------
----------------
----------------
----------------
-------E--------
---E--<>--------
--<>--[]--------
--[]--[]--------
E-[]--[]--------
XXXXXXXX--XXXXXX
