----------------
----------------
----------------
----------------
----------------
----------------
----------------
----------------
----------------
----------------
----------S-----
---<>-----------
---[]-----------
---[]-----------
-E-[]-----------
XXXXXXXXXXXXXXX-
