----------------
----------------
----------------
----------------
SSSSSSSSSSSSSSS-
----------------
----------------
----------------
----------------
----------------
-----------E----
----------<>----
-------XX-[]--XX
------XXX-[]--XX
--E-E-XXX-[]--XX
XXXXXXXX--XX--XX
