----------------
----------------
----------------
----------------
----------------
----------------
----------------
----------------
---------------E
---------E----<>
--------<>----[]
---SS---[]----XX
--------[]------
--------[]------
--------[]------
XXXXXXXXXXXXXXXX
