----------------
----------------
----------------
----------------
----------SSSSSS
----------------
--XXX-----------
-------SSS------
----------------
-------S--------
------S-S-------
---------S------
---------------<
---------------[
---------------[
------XXXXXXXXXX
