----------------
----------------
----------------
----------------
----------------
----------------
----------------
----------------
----E-----------
---<>-----------
---[]-----------
---XX-----------
-----------E----
----------<>----
----------[]----
--XXXXXXXXXXXXXX
