----------------
----------------
----------------
----------------
SSSSSSSSSSSSSSSS
----------------
----------------
----------------
----------------
----------------
----------------
----------------
-------------XX-
------------XXX-
--------E-E-XXX-
XXXXXXXXXXXXXX--
