----------------
----------------
----------------
----------------
----------------
----------------
----------------
----------------
----------------
----------------
----------------
----------------
-----------X----
-------E---X----
-----------X----
XXXXXXXXX--XXXXX
