----------------
----------------
----------------
----------------
----------------
----------------
----------------
----SS----------
----------------
------------o---
----------------
---XXXX--SSS----
XXXXX-----------
XXX-------------
X---------------
-----XX--XXXXXXX
