----------------
----------------
----------------
----------------
----------------
----------------
----------------
----------------
----------------
----------------
----------------
----------------
----------------
----------------
E------EE-E-----
XXXXXXXXXXXXXXXX
