----------------
----------------
----------------
----------------
----------------
----------------
----------------
----------------
--E-------------
----------------
----------------
----------EE-E--
-------XXXXXXXXX
----------------
----------------
----XXX---------
