----------------
----------------
----------------
----------------
----------------
----------------
----------------
----------------
----------------
----------------
--------------X-
-------------XX-
----E----E--XXX-
-----------XXXX-
----------XXXXX-
XXXXXXXXXXXXXXXX
