----------------
----------------
----------------
----------------
----------------
----------------
----------------
----------------
----------------
----------------
--------------oo
----------------
----------------
-X---X----------
-X-E-X----------
XXXXXXXXXXXX----
