----------------
----------------
----------------
----------------
----------------
----------------
---------oo-----
XX------XXXX----
-------------o--
------------XXX-
----------------
-XXX------------
------------o---
-----XXX---XXXXX
----------------
----------------
