----------------
----------------
----------------
----------------
----------------
----------------
----------------
----------------
----------------
----------------
---------E------
--------<>---SS-
E-------[]------
>-------[]------
]-------[]------
XXXXXXXXXXXXXXXX
