----------------
----------------
----------------
----------------
----------------
----------------
----------------
----------------
----------------
----------------
----------------
----------------
-----------E----
----------------
----------------
XXXXXXXXXXXXXXXX
