----------------
----------------
----------------
----------------
----------------
----------------
----------------
----------------
----------------
----------------
-----------E----
---E------<>----
--<>------[]--E-
--[]------[]-<>-
--[]------[]-[]-
XXXXXXXXXXXXXXXX
