----------------
----------------
----------------
----------------
----------------
----------------
----------------
----------------
----------------
----------------
----------------
-------E------E-
------<>-----<>-
------[]-----[]-
E-----[]-----[]-
XXXXXXXXXXX--XXX
