----------------
----------------
----------------
----------------
----------------
----------------
----------------
S---------------
-------E--------
------<>--------
------[]--------
ES----[]------E-
>---E-[]-----<>-
]--<>-[]-----[]-
]--[]-[]-----[]-
XXXXXXXXXXXXXXXX
