----------------
----------------
----------------
----------------
----------------
----------------
----------------
----------------
----------------
----------------
----------------
----------------
--------E-------
-------<>-------
-------[]-------
XXXXXXXXXXXXXXXX
