----------------
----------------
----------------
----------------
----------------
----------------
----------------
----------------
----------------
----------------
----------------
----------------
----------------
---------------X
--------------XX
XXXXXXXXXXXXXXXX
