----------------
----------------
----------------
----------------
----------------
----------o-----
---------XXX----
-------------o--
--o---o------XXX
-XXX-XXX--------
----------------
----------------
----------------
----------------
----E-----------
XXXXXXXXXXXXX---
