----------------
----------------
----------------
----------------
----------------
----------------
----------------
----------------
----------------
----------------
----------------
-------XSSS-----
-------X--------
-------X--------
----E-EX--------
XXXXXXXXXXXX---X
