----------------
----------------
----------------
----------------
----------------
----------------
----------------
E---------------
>---------------
]---------------
XX------------E-
-------------<>-
---E-E-------[]-
--<><>-------[]-
--[][]-------[]-
XXXXXXXXXXXXXXXX
