----------------
----------------
----------------
----------------
----------------
----------------
----------------
----------------
----------------
----------------
-E--------------
<>--------------
----------------
----------------
-------------EE-
XXXXXXX---XXXXXX
