----------------
----------------
----------------
----------------
----------------
----------------
----------------
------XX--------
------XX--------
----XXXX--------
----XXXX--------
--XXXXXX--------
--XXXXXX--------
--XXXXXX--------
--XXXXXX--------
XXXXXXXXXXXXXXXX
