----------------
----------------
----------------
----------------
----------------
----------------
----------------
--------SSSSS---
----------------
----------------
--E-------------
-<>---QQQQ--QQQ-
-[]-------------
-[]-------------
-[]-------E-EE--
XXXXXXXXXXXXXXXX
