----------------
----------------
----------------
----------------
----------------
----------------
----------------
-------SSSSSSSS-
----------------
----------------
----------------
------X----S----
------X------E--
------X---------
E-EE--X---------
XXXXXXXXXXXXXXXX
