----------------
----------------
----------------
----------------
----------------
----------------
----------------
SSSS------------
----------------
----------------
----------------
S----X----------
--E--X-------E--
-----X----------
-----X----------
XXXXXXXXXXX-X-XX
