----------------
----------------
----------------
----------------
SSSSSSSSSSSSSS?S
-SSSS-----------
-SSSS-----------
---------oooooo-
----------------
---------SSSSSS-
--E------SSSSSS-
-SSSS-----------
EE--------------
----------------
----------------
XXXXX---XXXXXXXX
