----------------
----------------
----------------
----------------
----------------
----------------
-------------Eoo
-------------XXX
----------------
----------------
----------------
-----------XXXXX
----------------
----------------
-----XXXX-------
XXX-------------
