----------------
----------------
----------------
----------------
----------------
----------------
----------------
----------------
----------------
----------------
----------------
----------------
---------E------
--------<>------
--------[]------
XXXXXXXXXXXXXXXX
