----------------
----------------
----------------
----------------
----------------
----------------
----------------
----------------
----------------
----X-----------
---XX--oo------o
--XXX-----------
-XXXX-----------
XXXXX-----------
XXXXX-----------
XXXXXXXXXXXXXX--
