----------------
----------------
----------------
----------------
----------------
----------------
----------------
----------QQQQ--
o---------------
----------------
----------------
--------QQ?SSQQQ
----------------
----------------
----------------
XXXXXXXXXXX--XXX
