----------------
----------------
----------------
----------------
----------------
----------------
----------------
----------------
----------------
--X-------------
-XX--oo------o--
XXX-------------
XXX-------------
XXX-------------
XXX-------------
XXXXXXXXXXXX---X
