----------------
----------------
----------------
----------------
----------------
----------------
----------------
----------------
----------------
----------------
----------------
----------------
---E------------
--<>-----------<
--[]-----------[
XXXXXXXXXXXXXXXX
