----------------
----------------
----------------
----------------
----------------
----------------
----------------
----------------
-----XXX--------
----------------
----------------
XXX------------X
---------------X
---------------X
-----------E---X
------XXXXXXXXXX
