----------------
----------------
----------------
----------------
----------------
----------------
----------------
----------------
----------------
----------------
---------SSSSSSS
----------------
----------------
E---------------
----------------
X-XX-XXXXXXXXXXX
