----------------
----------------
----------------
----------------
----------------
----------------
----------------
----------------
----------------
----------------
----------------
---------XXXX---
----------------
----------------
----------------
XXXX--XXXX--XXXX
