----------------
----------------
----------------
----------------
----------------
----------------
----------------
----------------
---------------X
--oo----------XX
-------------XXX
X------------XXX
X----------XXXXX
X---------XXXXXX
X------------XXX
---XXXXXXXXXXXXX
