----------------
----------------
----------------
----------------
----------------
----------------
----------------
S-------------SS
----------------
----------------
----------------
S-------E-XX--SS
-----XX<>-XX----
----XXX[]-XXX---
---XXXX[]-XXX---
XXXXXX-XXXXXXXXX
