----------------
----------------
----------------
----------------
SSSSSSSSSSSSSSSS
----SSSSSSSSSSSS
----SSSSSSSSSSSS
----SSSSSSSSSSSS
----------------
----------------
------------?---
------SSSSSS??SS
------SSSSS---SS
------SSSSS---SS
-----------oooSS
-X---XXXXXXXXXXX
