----------------
----------------
----------------
----------------
----------------
----------------
----------------
----------------
----------------
----------------
----------------
QQ--------------
----------------
-------------XXX
----------XXXXXX
XXXX--XXXXXXXXX-
