----------------
----------------
----------------
----------------
----oo----------
----------------
----------------
----XXX---------
----------------
----------------
----------------
X------XXXXX----
----------------
----------------
----------------
XXXX---------XXX
