----------------
----------------
----------------
----------------
----------------
----------------
----------------
----------------
----------------
----------------
----------------
X------------SSQ
XX--------------
XXX-----<>------
XXXX----[]------
XXXXXXXXXXXXXXXX
