----------------
----------------
----------------
----------------
SSSSSSSSSSSSSSSS
SSSSSSSSSSSSSSSS
SSSSSSSSSSSSSSSS
SSSSSSSSSSSSSSSS
----------------
----------------
-------------E-E
?SSSSSSSSSSSSSSS
-SSSSSSSSSSSSSSS
-SSSSSSSSSSSSSSS
oSSSSSSSSSSSSSSS
XXXXXXXXXXXXXXXX
