----------------
----------------
----------------
----------------
----------------
----------------
----------------
----------------
-----XSSS-------
----XXX---------
---XXXS---------
---XXXX---------
-XXXXXX-SSS-----
XXXXXXX---------
---XXXX---------
XXXXXXXXX---XXXX
