----------------
----------------
----------------
----------------
-----?----------
----------------
----------------
----------------
-------SS-------
------------X---
---SS------XX---
----------XXX---
---------XXXX---
--------XXXXX---
-------XXXXXX---
XXXXXX-XXXXXXXXX
