----------------
----------------
----------------
----------------
----------------
----------------
----------------
-----SSSSS------
----------------
----------------
------E---------
-----SSSSS------
E-----------X---
>-----------X---
]-----------X---
XXXXXXXXXXXXXXXX
