----------------
----------------
----------------
----------------
----------------
----------------
----------------
----------------
----------------
----------------
----------------
------------X---
----E------XXX--
---<>-----XXXX--
---------XXXX---
XXXXXXXXXXXXX---
