----------------
----------------
----------------
----------------
----------------
----------------
----------------
----------------
----------------
----------------
----------------
----------------
---------------X
--------------XX
-------------XXX
XXXXXXXX---XXXXX
