----------------
----------------
----------------
----------------
----------------
----------------
----------------
----------S-----
----------------
----------------
---------E-EE---
----X--------XX-
---XXX-------XX-
--XXXX-------XX-
-XXXX--------X--
XXXXX--------X--
