----------------
----------------
----------------
----------------
SSSSSSSSSSSSSSSS
----------------
----------------
------E---------
-----<>---------
-----[]---------
-----[]-------S-
E--SS[]SS---E---
>----[]----<>---
]----[]----[]---
]-E--[]----[]---
XXXXXXXXXXXXXXXX
