----------------
----------------
----------------
----------------
SSSSSSSSSSSSSSSS
----------------
----------------
----------------
----------------
----------------
-E--------------
<>--------------
[]-----E-----SS-
[]----<>-----SS-
[]--E-[]-----SS-
XXXXXXXXXXX--XX-
