----------------
----------------
----------------
----------------
----------------
----------------
----------------
----?SS---------
----------------
----------------
----------------
----------------
-E--------------
----------------
----------------
XXXXXXXXXXXXXXXX
