----------------
----------------
----------------
----------------
----------------
----------------
----------------
-----SSSSS------
----------------
----------------
----------------
---QQQQ--QQQ----
----------------
----------------
-------E-EE-----
XXXXXXXXXXXXXXXX
