----------------
----------------
----------------
----------------
----------------
----------------
----------------
------o-o----XXX
XXX-------------
----------------
------XXXX------
-----------XXX-X
----------------
--XXXX----------
----------------
----------------
