----------------
----------------
----------------
----------------
----------------
----------------
----------------
----------------
----------------
----------------
----------------
---------------E
--------------<>
--------------[]
---EE-E-------[]
XXXXXXXXXXXXXXXX
