----------------
----------------
----------------
----------------
----------------
----------------
----------------
----------------
----------------
----------------
--------E-------
-------<>---SS--
-------[]-------
-------[]-------
-------[]-------
XXXXXXXXXXXXXXXX
