----------------
----------------
----------------
----------------
----------------
----------------
----------------
SS--------------
----------------
----------------
----------------
XXX-------------
----------------
----------------
------------EE-E
X----XXXXXXXXXXX
