----------------
----------------
----------------
----------------
----------------
----------------
----------------
----------------
----------------
----------------
----------------
-------QQ-------
----------------
----------------
----------------
XXXXXXXXXXX--XXX
