----------------
----------------
----------------
----------------
----------------
----------------
----------------
--------SSS-----
---------------<
---------------[
---------------[
--E-XX--SSS----X
X<>-XX----------
X[]-XXX---------
X[]-XXX--------E
-XXXXXXXXXXXXXXX
