----------------
----------------
----------------
----------------
----------------
----------------
----------------
----------------
----------------
----------------
----Q--?--------
-Q-E------ESSS--
---E------------
----------------
----------------
XXXXXXXXXXXXXXXX
