----------------
----------------
----------------
----------------
--------ooo-----
--------XXXX----
----------------
--XX------------
----------------
----------------
-------------XXX
-----XX---------
--------XXXXXX--
----------------
----------------
----------------
