----------------
----------------
----------------
----------------
----------------
----------------
----------------
----------------
----------------
----------------
----------------
---E------------
--<>----E-------
--[]------------
--[]-----------E
--XXXXXXXXXXXXXX
