----------------
----------------
----------------
----------------
----------------
----------------
----------------
SS------------SS
----------------
----------------
------------SS--
----------------
------E---E-----
-----<>--<>-----
-----[]--[]-----
---XXXXXXXXXXXX-
