----------------
----------------
----------------
----------------
----------------
----------------
----------------
--------------SS
----------------
----------------
-------E--------
------<>------SS
----------------
----------------
--E-------------
XXXXXXXXXXXXXXXX
