----------------
----------------
----------------
----------------
----------------
----------------
----------------
----------------
----------------
----------------
------E---------
-----<>---------
-----[]---------
-----[]---------
--E--[]----E-E--
XXXXXXXXXXXXXXXX
