----------------
----------------
----------------
----------------
----------------
----------------
----------------
-----SS---------
----------------
-------------o--
----------------
----XXXX--SSS---
-XXXXX----------
XXXX------------
XX--------------
------XX--XXXXXX
