----------------
----------------
----------------
----------------
-----------oo---
----?-----XXXX--
----------------
----------------
------E--------X
--XXXXXX--------
----------------
XX-----ooo------
---------E------
-XXXXXXXXXX-----
----------------
----------------
