----------------
----------------
----------------
----------------
----------------
----------------
----------oo----
XXX------XXXX---
--------------o-
-------------XXX
----------------
X-XXX-----------
-------------o--
------XXX---XXXX
----------------
----------------
