----------------
----------------
----------------
----------------
----------------
----------------
--oo------------
----------------
----------------
----------------
----------------
----------------
---------E------
--------<>------
E-EE----[]-E----
XXXXXXXXXXXXXXXX
