----------------
----------------
----------------
----------------
----------------
----------------
----------------
----------------
----------------
----------------
-----------E----
----------<>----
----------[]----
----------[]----
---EE-----[]----
XXXXXXXXXXXXXXXX
