----------------
----------------
----------------
----------------
----------------
----------------
--------oo------
X------XXXX-----
------------o---
-----------XXX--
----------------
XXX-------------
-----------o----
----XXX---XXXXX-
----------------
----------------
