----------------
----------------
----------------
----------------
----------------
----------------
----------------
----------------
----------------
----------------
----------------
----------------
----------------
----------------
---E--E-EE------
XXXXXXXXXXXXXXXX
