----------------
----------------
----------------
----------------
----------------
----------------
----------------
----------------
----------------
----------------
--XSS-SQ--------
-XXX------------
XXXX------------
XXXX------------
XXXX--SSSSS-----
XXX-------XX-XXX
