----------------
----------------
----------------
----------------
----------------
----------------
XXX-------------
---------------X
----------------
----------------
-----SSSSS??----
----------------
XXX-------------
----------------
--------E-------
-----XXXXXXXX--X
