----------------
----------------
----------------
----------------
----------------
----------------
----------------
----------SSSS--
----------------
----------------
----------------
---------S-----<
---------------[
---------------[
E-E--E--EE-E---[
XXXXXXXXXXXXXXXX
