----------------
----------------
----------------
----------------
----------------
----------------
----------------
---------------E
--------------<>
--------------[]
------E-------[]
-----<>------SXX
-----[]--E------
-----[]-<>------
-----[]-[]------
XXXXXXXXXXXXXXXX
