----------------
----------------
----------------
----------------
----------------
----------------
----------oooooo
-------XX-------
----------------
-------------XX-
----------------
XXX-------------
----------------
----------------
----------------
----XXXX--XXXX--
