----------------
----------------
----------------
----------------
----------------
----------------
----------------
---------------Q
----------------
----------------
---------E------
--------<>----E?
--------[]------
--------[]------
-EE-----[]------
XXXXXXXXXXXXXXXX
