----------------
----------------
----------------
----------------
----------ooo---
----------XXXX--
----------------
----XX----------
----------------
----------------
---------------X
XX-----XX-------
----------XXXXXX
----------------
----------------
----------------
