----------------
----------------
----------------
----------------
----------------
----------------
----------------
----------------
------------XSSS
o----------XXX--
----------XXXS--
----------XXXX--
--------XXXXXX-S
-------XXXXXXX--
----------XXXX--
XXXXXXXXXXXXXXXX
