----------------
----------------
----------------
----------------
SSSSSSSSSSSSSSSS
---SSSS---------
---SSSS---------
S----------ooooo
S---------------
S----------SSSSS
S---E------SSSSS
S--SSSS---------
--EE------------
----------------
----------------
XXXXXXX---XXXXXX
