----------------
----------------
----------------
----------------
----------------
----------------
----------------
----------SSQSSS
----------------
----------------
---E------------
--<>------SSSSSS
----------------
----------------
----------------
XXXXXXXXXXXXXXXX
