----------------
----------------
----------------
----------------
----------------
----------------
----------------
--S-------------
----------------
----------------
---------------X
--S-----------XX
-------------XXX
------------XXXX
-----------XXXXX
XXXXXXXXXXXXXXXX
