----------------
----------------
----------------
----------------
----------------
----------------
----------------
----------------
-oooo----------o
----------------
-------------E--
------------<>--
------------[]--
------------[]--
------------[]--
XXXXXXXXXXXXXXXX
