----------------
----------------
----------------
----------------
----------------
----------------
----------------
----------------
----------------
----------------
----------XSS-SQ
---------XXX----
--------XXXX----
-------XXXXX----
------XXXXXX--SS
XXXXXXXXXXX-----
