----------------
----------------
----------------
----------------
----------------
----------------
----------------
----------------
---------E------
--------<>------
--------[]------
SSS-----XX------
----------------
---------------<
---------------[
XXXX---XXXXXXXXX
