----------------
----------------
----------------
----------------
----------------
----------------
----------------
----------------
----------------
----------------
----------------
----------------
----------------
--------------E-
----------------
XXX---XXXXXXXXXX
