----------------
----------------
----------------
----------------
----------------
----------------
----------------
----------------
-----------E----
----------<>----
----------[]----
-XSSS-----XX----
-X--------------
-X--------------
EX--------------
XXXXXX---XXXXXXX
