----------------
----------------
----------------
----------------
----------------
----------------
----------------
SS--------------
----------------
----------------
----------------
-----------QQQQ-
----------------
-----------E----
----------------
XXXXXXXXXXXXXXXX
