----------------
----------------
----------------
----------------
----------------
----------------
----------------
----------------
----------------
----------------
SQ--------------
----------------
---------------X
--------------XX
SSSSS--------XXX
----XX-XXXXXXXXX
