----------------
----------------
----------------
----------------
----------------
----------------
----------------
----------------
----------------
----------------
E---------------
>-----E---------
]----<>---------
]----[]---------
]----[]--------X
XXXXXXXXXXXXXXXX
