----------------
----------------
----------------
----------------
----------------
----------------
----------------
-XXX------------
-XXX------------
-XXX------------
-XXX------------
-XXX------------
-XXX------------
-XXX------------
-XXX-------XX---
-XXXXXXXXXXXXXXX
