----------------
----------------
----------------
----------------
----------------
----------------
----------------
----------------
----------------
----------------
Q---------------
---------------X
--------------XX
-------------XXX
SSSS--------XXXX
---XX-XXXXXXXXXX
