----------------
----------------
----------------
----------------
----SSSS-----SSS
----------------
-----?----------
----S??---------
---------XXX----
----------------
----------------
XXX-SSSS--------
----------------
----------------
----------------
----XXXX------XX
