----------------
----------------
----------------
----------------
----------------
----------------
----------------
----------------
----------------
----------------
-?--------------
----ESSS----E---
-----------<>---
----------------
----------------
XXXXXXXXXXXXXXXX
