----------------
----------------
----------------
----------------
----------------
----------------
----------------
----------------
----------------
----------------
--Q--?----------
-E------ESSS----
-E-------------<
----------------
----------------
XXXXXXXXXXXXXXXX
