----------------
----------------
----------------
----------------
-----------oo---
----------------
----------------
-----------XXX--
----------------
----------------
----------------
----XXXX------XX
----------------
----------------
----------------
-XXXX--XXXX-----
