----------------
----------------
----------------
----------------
----------------
----------------
----------------
----------------
----------------
----------------
E---------------
>---------------
]-----------E---
]----------<>---
]--------E-[]--E
XX---XXXXXXXXXXX
