----------------
----------------
----------------
----------------
SSSSSSSSSSSSSSSS
----------------
----------------
----------------
----------------
----------------
----------------
----------------
---SS-----------
---SS---------EX
---SS---------XX
X--XX--XXXXXXXXX
