----------------
----------------
----------------
----------------
----------------
----------------
----------------
----------------
----------------
----------------
----------------
--------E-------
-------<>-------
-------[]-------
-------[]-----E-
XXXXXXXXXXXXXXXX
