----------------
----------------
----------------
----------------
----------------
----------------
----------------
----------------
----------------
----------------
----------------
----------------
---------------<
---------------[
EE-E-----E-----[
XXXXXXXXXXXXXXXX
