----------------
----------------
----------------
----------------
----------------
----------------
----------------
----------------
----------------
----------------
----------------
----------------
----E-----------
----------------
-----------EEE--
XXXXXXXXXXXXXXXX
