----------------
----------------
----------------
----------------
----------------
----------------
----------------
--SSSSS---?-----
----------------
----------------
----------------
---E-----------E
--------E-----<>
--------------[]
--------------[]
XXXXXXXXXXXXXXXX
