----------------
----------------
----------------
----------------
----------------
----------------
----------------
------E---------
-----<>---------
-----[]---------
--E--XXX--------
-<>-------------
-[]------E-E----
-[]-----<><>----
-[]-----[][]----
XXXXXXXXXXXXXXXX
