----------------
----------------
----------------
----------------
SSSSSSSSSSSSSSSS
----------------
----------------
----------------
----------------
----------------
----------------
-E--------------
<>-------------X
[]------------XX
[]--------E-E-XX
XXXXXXXXXXXXXXXX
