----------------
----------------
----------------
----------------
----------------
----------------
----------------
-?SSS-----------
----------------
-------E--------
------<>--------
---E--[]--------
--<>--[]--------
--[]--[]--------
--[]--[]--------
XXXXXXXXXXXXXXX-
