----------------
----------------
----------------
----------------
----------------
--------oo------
----------------
----------XXXX--
XX--------------
o---------------
---XXX----------
----------------
----------------
----------------
----------------
--------------XX
