----------------
----------------
----------------
----------------
----------------
----------------
----------------
---------------S
----------------
----------------
----------------
--------------XX
-----------XXXXX
--------XXXXXX--
-----XXXXXXX----
-XXXXXXXXX------
