----------------
----------------
----------------
----------------
----------------
----------------
----------------
----------QQQQQ-
----------------
----------------
----E-----------
---<>----E?QQQQ-
---[]-----------
---[]-----------
---[]-----------
XXXXXXXXXXXXXXXX
