----------------
----------------
----------------
----------------
----------------
----------------
----------------
----------------
----------------
----------------
---------------E
-----SSS------<>
--------------[]
--------------[]
--------------[]
XXXXXXXXXXXXXXXX
