----------------
----------------
----------------
----------------
----------------
----------------
----------------
----XXX-----oo--
-----------XX---
----------------
----------------
--------------XX
----------------
----------------
----------------
XXX----XXXX-----
