----------------
----------------
----------------
----------------
----------------
----------------
----------------
-XXX-----oo--XXX
--------XX------
----------------
----------------
-----------XX---
----------------
----------------
----------------
----XXXX-----XXX
