----------------
----------------
----------------
----------------
----------------
----------------
----------------
----------------
----------------
----------------
----------------
------E------E--
-----<>-----<>--
-----[]-----[]--
-----[]-----[]--
XXXXXXXXXX--XXXX
