----------------
----------------
----------------
----------------
----------------
----------------
----------------
---------------E
----------------
----------------
---------------E
---E----------<>
--<>----------[]
--[]---------X[]
--[]--------XX[]
XXXXXXXXXXXXXXXX
