----------------
----------------
----------------
----------------
----------------
----------------
----------------
---------------S
-----------E----
-----E----<>----
----<>----[]----
S---[]----XXX---
----[]----------
----[]---------<
----[]---------[
XXXXXXXXXXXXXXXX
