----------------
----------------
----------------
----------------
SS?SSSSSSSSSSSSS
----------------
----------------
ooo-------------
----------------
SSS-------------
SSS-------------
----------------
----------------
----------------
---------E-EE---
XXXXXXXXXXXXXXXX
