----------------
----------------
----------------
----------------
----------------
----------------
----------------
----------------
----------------
----------------
----------------
-SSQS-----------
----------------
------------<>-X
-------EE---[]XX
XXXXXXXXXXXXXXXX
