----------------
----------------
----------------
----------------
----------------
----------------
----------------
----------------
----------------
----------------
----------------
---E------E-----
--<>-----<>----E
--[]-----[]-----
--[]-----[]-----
XXXXXXX--XXXXXXX
