----------------
----------------
----------------
----------------
----------------
----------------
----------------
----------------
----------------
-------------E--
---E--------<>--
--<>---SS---[]--
--[]--------[]--
--[]--------[]--
--[]--------[]--
XXXXXXXXXXXXXXXX
