----------------
----------------
----------------
----------------
----------------
----------------
----------------
----------------
----------------
----------------
----------------
----------ooo---
----------------
----------------
----------------
XXXXX--XXXXXXXXX
