----------------
----------------
----------------
----------------
----------------
----------------
----------------
--XX------------
-XXX------------
XXXX------------
XXXX------------
XXXX---S--------
XXXX------------
XXXX------------
XXXX--------X---
XXXXXXXXXXXXXXXX
