----------------
----------------
----------------
----------------
----------------
----------------
----------------
----------------
----------------
----------------
--------------E-
------E------<>-
-----<>------[]-
-----[]------[]-
-----[]------[]-
XXXXXXXXXXXXXXXX
