----------------
----------------
----------------
----------------
-----SSSSSSSSSSS
----------------
----------------
----------------
-XXX------------
----------------
----------------
----------------
---------E-----<
--------<>-----[
--------[]---E-[
------XXXXXXXXXX
