----------------
----------------
----------------
----------------
SSSSSSS---------
----------------
---------XXX----
QQ------------SS
----------------
--------------S-
-------------S-S
QQ--QQQ---------
----------------
----------------
----------------
XXXXXXX------XXX
