----------------
----------------
----------------
----------------
----------------
----------------
----------------
---------------S
----------------
----------------
----------------
---------------S
----------E-----
---------<>-----
---------[]-----
XXXXXXXXXXXXXXXX
