----------------
----------------
----------------
----------------
SSSSSSSSSSSSSSSS
---SS--SSSSSS--S
---SS--SSSSSS--S
-SS--------SS---
-SS--------SS---
-SS--------SS---
-SS----ooooSS---
-SSSS--SSSSSS---
---SS-----------
---SS-----------
--E------E--E---
XXXXXXXXXXXXXXXX
