----------------
----------------
----------------
----------------
SSSSSSSSSSSSSSSS
-----SSSSSSSSSSS
-----SSSSSSSSSSS
-----SSSSSSSSSSS
----------------
----------------
-------------?--
-------SSSSSS??S
-------SSSSS---S
-------SSSSS---S
------------oooS
--X---XXXXXXXXXX
