----------------
----------------
----------------
----------------
----------------
----------------
----------------
----------------
----------------
----------------
----o-----------
----------------
----------------
----------------
---------EE-E---
XXXXXXXXXXXXXXXX
