----------------
----------------
----------------
----------------
----------------
----------------
----------------
----------------
----------------
o---------------
----------------
----------------
----------------
----------------
----------------
XXXXXXXXXXXXX--X
