----------------
----------------
----------------
----------------
----------------
----------------
----------------
----------------
-----E----------
----<>----------
----[]----------
----XX----------
------------E---
-----------<>---
-----------[]---
---XXXXXXXXXXXXX
