----------------
----------------
----------------
----------------
SSSSSSSSSSSSSSSS
----------------
----------------
----------------
----------------
----------------
------------E---
-----------<>---
--------XX-[]--X
-------XXX-[]--X
---E-E-XXX-[]--X
XXXXXXXXX--XX--X
