----------------
----------------
----------------
----------------
----------------
----------------
----------------
------S---------
----------------
----------------
----------------
----QQQQ--------
----------------
----------------
----------------
XXXXXXXXXXXXXXXX
