----------------
----------------
----------------
----------------
----------------
----------------
----------------
----------------
----------------
----------------
----------------
-----E----------
----<>-----E----
----[]----<>----
----[]-E--[]----
XXXXXXXXXXXXXXXX
