----------------
----------------
----------------
----------------
----------------
----------------
----------------
S---------------
----------------
-----------o----
------------E---
S--------SSSSS--
------E--E------
-------------E--
----------------
XXXXXXXXXXXXXXXX
