----------------
----------------
----------------
----------------
----------------
----------------
----------------
---------------S
----------------
----------------
----------------
------------S---
-----X----------
-E---X----------
-----X-----EE---
XXX--XXXXXXXXXXX
