----------------
----------------
----------------
----------------
----------------
----------------
----------------
----------------
----------------
----------------
--oo------o----o
----------------
----------------
----------------
----------------
XXXXXXXXX---XX--
