----------------
----------------
----------------
----------------
----------------
----------------
----------------
----------------
----------------
----------------
----------------
----------------
-------E--------
------<>--------
------[]--------
XXXXXXXXXXXXXXXX
