----------------
----------------
----------------
----------------
----------------
----------------
----------------
----------------
----------------
----------------
---------------X
--------------XX
-------------XXX
------------XXXX
-----------XXXXX
XXXXXX---XXXXXXX
