----------------
----------------
----------------
----------------
----------------
----------------
----------------
---SSSSSSSSS----
----------------
----------------
----------------
----------------
E---------------
>--------------<
]--------------[
XXXXXXX------XXX
