----------------
----------------
----------------
----------------
----------------
----------------
----------------
----------------
----------------
----------------
----------------
-------S?S-----E
--------------XX
-------------XXX
------------XXXX
XXXXXXXXXXXXXXXX
