----------------
----------------
----------------
----------------
----------------
----------------
----------------
----------------
----------------
----------------
----------------
X---------------
----------------
----------------
----------EE-E--
---XXXXXXXXXXXXX
