----------------
----------------
----------------
----------------
---------SSSSSSS
----------------
-XXX------------
------SSS-------
----------------
------S---------
-----S-S--------
--------S------E
--------------<>
--------------[]
--------------[]
-----XXXXXXXXXXX
