----------------
----------------
----------------
----------------
----------------
----------------
----------------
-------XX-------
-------XX-------
-------XX-------
----X--XX-------
---XX--XX-------
--XXX--XX-------
-XXXX-----------
XXXXX-----------
XXXXXXXXXXXXXXXX
