----------------
----------------
----------------
----------------
----------------
------------?---
----------------
----------------
o----ooo------E-
----------XXXXXX
----------------
------XXXX-----o
----------------
---------XXXXXXX
XXXXXX----------
----------------
