----------------
----------------
----------------
----------------
----------------
----------------
----------------
----------------
----------------
----------------
XXXX------oooo--
----------------
X---------------
----------------
----------------
---XXXXXXXXX-XXX
