----------------
----------------
----------------
----------------
----------------
----------------
----------------
--------SSS-----
----------------
----------------
--------SSS-----
S---------------
----------------
----------------
---------------X
XXXXXXX----XXXXX
