----------------
----------------
----------------
----------------
----------------
----------------
----------------
----------------
----------------
----------------
----------------
----------------
X---------------
X---------------
X---------------
X--XXXXXXXXXXXXX
