----------------
----------------
----------------
----------------
SSSSSSSSSSSSSSSS
------------SS--
------------SS--
ooo-------SS----
----------SS----
SSS-S-----SS----
--SoS-----SS----
--SSS-----SSSS--
------------SS--
------------SS--
EE---------E----
XXXXXXXXXXXXXXXX
