----------------
----------------
----------------
----------------
SSSSSSSS--------
----------------
----------XXX---
----------------
----------------
----------------
---------------S
------XXX-------
-----EXXX-XXX---
---EXXXXX-------
---XXXXXX-------
XXXXXXXX-------X
