----------------
----------------
----------------
----------------
----------------
----------------
----------------
---------------X
S-------------XX
----X--------XXX
---XX-------XXXX
--XXX------XXXXX
-XXXX-----XXXXXX
XXXXX----XXXXXXX
XXXXX---XXXXXXXX
XXXXXXXXXXXXXXXX
