----------------
----------------
----------------
----------------
----------------
----------------
----------------
-SSSSS---?------
----------------
----------------
----------------
--E-----------E-
-------E-----<>-
-------------[]-
-------------[]E
XXXXXXXXXXXXXXXX
