----------------
----------------
----------------
----------------
----------------
----------------
----------------
----------------
----------------
----------------
-SQ-------------
----------------
----------------
---------------X
-SSSSS--------XX
-----XX-XXXXXXXX
