----------------
----------------
----------------
----------------
----------------
----------------
----------------
---------QQQQQ--
----------------
----------------
---E------------
--<>----E?QQQQ--
--[]------------
--[]------------
--[]-----------E
XXXXXXXXXXXXXXXX
