----------------
----------------
----------------
----------------
----------------
----------------
----------------
--Q-------------
----------------
----------------
----------------
--?-------------
----------------
----------------
----------------
XXXXXXXXX--XXXXX
