----------------
----------------
----------------
----------------
SSS----------SSS
----------------
-----XXX--------
----------SSS---
----------------
----------S-----
---------S-S----
QQQ---------S---
----------------
----------------
----------------
XXX------XXXXXXX
