----------------
----------------
----------------
----------------
----------------
----------------
----------------
----------------
----------------
----------------
----------------
----------------
----------------
----------------
EE-E--E------E--
XXXXXXXXXXXXXXXX
