----------------
----------------
----------------
----------------
SSSSS-----------
----------------
-------XXX------
----------------
----------------
----------------
------------SSSS
---XXX----------
--EXXX-XXX------
EXXXXX----------
XXXXXX---------E
XXXXX-------XXXX
