----------------
----------------
----------------
----------------
-----ooo--------
-----XXXX-------
----------------
X---------------
----------------
----------------
----------XXXX--
--XX------------
-----XXXXXX-----
----------------
----------------
-------------XXX
