----------------
----------------
----------------
----------------
SSSSSSSSSSSSSSSS
----------------
----------------
----------------
----------------
----------------
--E-------------
-<>-------------
-[]-----E-----SS
-[]----<>-----SS
-[]--E-[]-----SS
XXXXXXXXXXXX--XX
