----------------
----------------
----------------
----------------
----------------
----------------
----oooo--------
----XXXX--------
----------------
----------------
----------------
--------------XX
XX-?------------
----------------
----------------
---XXXXX-XXXXX--
