----------------
----------------
----------------
----------------
----------------
----------------
----------------
----------------
----------------
-------------oo-
----------------
oo-------XXX----
--------XXXX----
-------XXXXX----
------XXXXXX----
XXXXXXXXXXX---XX
