----------------
----------------
----------------
----------------
----------------
----------------
----------------
----------------
----------------
--------oo------
----------------
----XXX---------
---XXXX---------
--XXXXX---------
-XXXXXX---------
XXXXXX---XXXXXXX
