----------------
----------------
----------------
----------------
----------------
----------------
----------------
SSS------SSSS---
----------------
----------------
----------------
--QQQ-----------
----------------
----------------
E-EE------------
XXXXXXXXX----XXX
