----------------
----------------
----------------
----------------
----------------
----------------
-------oo-------
----------------
----------------
----------------
---E------------
--<>------------
--[]----------E-
--[]---------<>-
--[]-E-EE----[]-
XXXXXXXXXXXXXXXX
