----------------
----------------
----------------
----------------
----------------
--------XX------
--------XX------
----S---XX------
--------XX------
--------XX------
--------XX------
---SS---XX------
--------XX------
--------XX------
--------XX------
XXXXXXXXXXXXXXXX
