----------------
----------------
----------------
----------------
----------------
----------------
----------------
----------------
----------------
----------------
----------------
------------E---
-----------<>---
-----------[]---
EE-E-------[]---
XXXXXXXXXXXXXXXX
