----------------
----------------
----------------
----------------
----------------
----------------
----------oo----
----------------
----------------
----------------
------E---------
-----<>---------
-----[]---------
-----[]---------
-----[]-E-EE----
XXXXXXXXXXXXXXXX
