----------------
----------------
----------------
----------------
----------------
----------------
----------------
----------------
----------------
----------------
----------------
----------------
----------------
----------------
----E------E-EE-
XXXXXXXXXXXXXXXX
