----------------
----------------
----------------
----------------
----------------
----------------
----------------
--S---SSSSSSSSS-
----------------
----------------
----------------
S---------------
---E------------
--<>------------
--[]------------
XXXXXXXXXX------
