----------------
----------------
----------------
----------------
----------------
----------------
----------------
----------------
----------------
----------------
----------------
--QQQQ----------
---------------E
--E-------------
----------------
XXXXXXXXXXXXXXXX
