----------------
----------------
----------------
----------------
----------------
----------------
----------------
----------------
----------------
----------------
-------------E--
---SSS------<>--
------------[]--
------------[]--
------------[]--
XXXXXXXXXXXXXXXX
