----------------
----------------
----------------
----------------
SSSSSSSSSSSSSSSS
------SSSS------
--E---SSSS------
--SS----------oo
--SS------------
--SS----------SS
?-SS---E------SS
--SS--SSSS------
-----EE---------
----------------
----------------
XXXXXXXXXX---XXX
