----------------
----------------
----------------
----------------
SSSSSSSSSSSSSSSS
SSSSSSSSSSSSSSSS
SSSSSSSSSSSSSSSS
SSSSSSSSSSSSSSSS
----------------
----------------
----?-----------
SSSS??SSSSSSSSSS
SSS---SSSSSSSSSS
SSS---SSSSSSSSSS
---oooSSSSSSSSSS
XXXXXXXXXXXXXXXX
