----------------
----------------
----------------
----------------
----------------
----------------
-------oo-------
------XXXX------
-----------o----
----------XXX---
----------------
XX--------------
----------o-----
---XXX---XXXXX--
----------------
----------------
