----------------
----------------
----------------
----------------
----------------
----------------
----------------
----------------
----------------
----------------
----------------
--------E-------
-------<>-------
-------[]-------
-E-EE--[]-------
XXXXXXXXXXXXXXXX
