----------------
----------------
----------------
----------------
----------------
----------------
----------------
----------------
----------------
----------------
----------------
-SSXSS----------
---------------<
---------------[
---------------[
XXXXXXXXXXXX--XX
