----------------
----------------
----------------
----------------
----------------
----------------
----------------
----------------
----------------
------------XXXX
----------------
----------------
--------XXXXX---
----------------
----------------
XXXXXX----------
