----------------
----------------
----------------
----------------
----------------
----------------
----------------
----------------
--oooo----------
----------------
--------------E-
-------------<>-
X------------[]-
X------------[]-
X------------[]-
XXXXXXXXXXXXXXXX
