----------------
----------------
----------------
----------------
----------------
----------------
----------------
----------------
----------------
----------------
----------------
----------------
----E-----------
---<>-----------
---[]-----------
XXXXXXXXXXXXXX--
