----------------
----------------
----------------
----------------
----------------
----------------
----------------
XX-----oo--XXXX-
------XX--------
----------------
----------------
---------XX---XX
----------------
----------------
----------------
--XXXX-----XXXX-
