----------------
----------------
----------------
----------------
----------------
----------------
-------------ooo
-------------XXX
---oo-----------
----------------
----------------
----------------
--------XXXX?---
----------------
----------------
---XXXX-----XXXX
