----------------
----------------
----------------
----------------
----------------
----------------
----------------
----------------
----------------
---------------E
S---------------
-------------S?S
----------------
----------------
----------------
XXXXX--XXXXXXXXX
