----------------
----------------
----------------
----------------
----------------
----------------
----------------
--XX------------
--XX------------
--XX------------
--XX------------
--XX------------
--XX------------
----------------
------------X---
XXXXXXXXXXXXXXXX
