----------------
----------------
----------------
----------------
----------------
----------------
----------------
----------------
----------------
-o--------------
----------------
S---------------
----------------
SSS-------------
----------------
---XXXXXXXXX---X
