----------------
----------------
----------------
----------------
----------------
----------------
----------------
----------------
----------------
----------------
?---------------
---ESSS----E----
----------<>----
----------------
---------------E
XXXXXXXXXXXXXXXX
