----------------
----------------
----------------
----------------
----------------
----------------
------oooo------
------XXXX------
----------------
----------------
----------------
----------------
-XXX-?----------
----------------
----------------
-----XXXXX-XXXXX
