----------------
----------------
----------------
----------------
----------------
----------------
----------------
----------------
----------------
----------------
----------------
----------------
----------------
---------------X
-----------EE--X
XX-X-X-XXXXXXXXX
