----------------
----------------
----------------
----------------
SSSSSSSSSSSSSSSS
SSSSSSSSSSSS----
SSSSSSSSSSSS----
SSSSSSSSSSSS----
----------------
----------------
oooooooo--------
SSSSSSSS----XX--
-----------XXX--
----------XXXX--
----EE---XXXXX--
XXXXXXXXXXXXXXXX
