----------------
----------------
----------------
----------------
----------------
----------------
----------------
----------------
----------------
----------------
----------------
---------------E
--------------<>
----------------
--------EE-E----
XX---XXXXXXXXXXX
