----------------
----------------
----------------
----------------
----------------
----------------
----------------
----------------
----------------
----------------
-------E--------
------<>---SS---
------[]--------
------[]--------
------[]--------
XXXXXXXXXXXXXXXX
