----------------
----------------
----------------
----------------
----------------
----------------
----------------
----------------
----------------
---------------X
----------------
----------------
-----------XXXXX
----------------
----------------
XXXXXXXXX-------
