----------------
----------------
----------------
----------------
----------------
----------------
----------------
------XX--------
-----XXX--------
----XXXX--------
---XXXXX--------
--XXXXXX---S----
-XXXXXXX--------
XXXXXXXX--------
XXXXXXXX--------
XXXXXXXXXXXXXXXX
