----------------
----------------
----------------
----------------
----------------
----------------
----------------
----------------
-----------XSSS-
----------XXX---
---------XXXS---
---------XXXX---
-------XXXXXX-SS
------XXXXXXX---
---------XXXX---
XXXXXXXXXXXXXXX-
