----------------
----------------
----------------
----------------
----------------
----------------
----------------
----------------
--------oooo----
----------------
------E---------
-----<>---------
-----[]---------
-----[]---------
-----[]---------
XXXXXXXXXXXXXXXX
