----------------
----------------
----------------
----------------
----------------
----------------
----------------
----------------
----------------
----------------
-----oooo-------
------------XXXX
----------------
----------------
----------------
XXXXXXX-XXXX----
