----------------
----------------
----------------
----------------
SSSS-------SSSS-
----------------
------------?---
-----------S??--
----------------
----------------
E---------------
>------XXX-SSSS-
]--XXX----------
]--XXX----------
]--XXX----------
X--XX------XXXX-
