----------------
----------------
----------------
----------------
----------------
----------------
----------------
----------------
----------------
----------------
----------------
-----E----------
----<>----------
----[]----------
----[]-----E-EE-
XXXXXXXXXXXXXXXX
