----------------
----------------
----------------
----------------
----------------
----------------
----------------
----------------
----------------
----------------
----------------
--------------QQ
----------------
----------------
----------------
XX----XXXXXXXXXX
