----------------
----------------
----------------
----------------
----------------
----------------
----------------
----------------
----------------
----------------
----------------
-------E--S-----
------<>--------
----------------
EE-E-----E------
XXXXXXXXXXXXXXXX
