----------------
----------------
----------------
----------------
SSSSSSSSSSSSSSSS
SSSSSSSS--------
SSSSSSSS--------
SSSSSSSS-----E--
------------<>--
------------[]--
oooo--------[]--
SSSS----XX--[]--
-------XXX--[]--
------XXXX--[]--
EE---XXXXX--[]--
XXXXXXXXXXXXXXX-
