----------------
----------------
----------------
----------------
----------------
----------------
----------------
----------------
----------------
---------o------
----------E-----
-------SSSSS----
----E--E-------X
-----------E---X
---------------X
XXXXXXXXXXXXXXXX
