----------------
----------------
----------------
----------------
----------------
----------------
----------------
--------SSSS----
----------------
----------------
--------------E-
-------S-----<>-
-------------[]-
-------------[]-
E--E--EE-E---[]-
XXXXXXXXXXXXXXXX
