----------------
----------------
----------------
----------------
----------------
----------------
----------------
----------------
----------------
----------------
--------o-----E-
--E----------<>-
-<>----------[]-
-[]----------[]-
-[]----------[]-
XXXXXXXXXXXXXXXX
