----------------
----------------
----------------
----------------
----------------
----------------
----------------
----------SSS---
----------------
----------------
----------------
----E-XX--SSS---
-XX<>-XX--------
XXX[]-XXX-------
XXX[]-XXX-------
XX-XXXXXXXXXXXXX
