----------------
----------------
----------------
----------------
----------------
----------------
----------------
----------------
----------------
----------------
--------------E-
----SSS------<>-
-------------[]-
-------------[]-
-------------[]-
XXXXXXXXXXXXXXXX
