----------------
----------------
----------------
----------------
-SSSSSSSSSSSSSSS
---------------S
---------------S
---------------S
----------------
----------------
----------------
----------------
----------------
----------------
----------------
XXXXXX--XX--X---
