----------------
----------------
----------------
----------------
----------------
----------------
---E------------
--SQS--SQS------
----------------
----------------
----------------
--SQS--S?S------
---------------E
----------------
E-----E---------
XXXXXXXXXXXXXXXX
