----------------
----------------
----------------
----------------
----------------
----------------
----------------
----------------
----------------
----------------
----------------
-----------E----
----------<>----
----------[]----
----E-EE--[]----
XXXXXXXXXXXXXXXX
