----------------
----------------
----------------
----------------
----------------
----------------
---------------o
o----XXX------XX
----------------
----------------
XX--------------
---XXX-XXX------
----------------
-----------XXX--
----------------
----------------
