----------------
----------------
----------------
----------------
----------------
----------------
----------------
----------------
----------------
----------------
SSSSSSS---------
----------------
----------------
----------------
----------------
XXXXXXXXXXXX-X-X
