----------------
----------------
----------------
----------------
----------------
----------------
----------------
----------------
----------------
----------------
----------------
---------------S
-----E----------
----------------
----------------
XXXXXXXXXXXXXXXX
