----------------
----------------
----------------
----------------
----------------
----------------
--------ooooooo-
-----XX---------
----------------
-----------XX---
----------------
X---------------
----------------
--------------XX
----------------
--XXXX--XXXX----
