----------------
----------------
----------------
----------------
SSSSSSSSSSSSSSSS
----------------
----------------
----------------
----------------
----------------
---------------E
-----------E--<>
----E-----<>--[]
---<>-----[]--[]
---[]---E-[]--[]
-XXXXXXXXXXXXXXX
