----------------
----------------
----------------
----------------
----------------
----------------
----------------
----------------
----------------
SS--o-----------
X---------------
X-SS------------
X---------------
X--SSS----------
X---------------
------XXXXXXXXX-
