----------------
----------------
----------------
----------------
SSSSSSSSSSSSSSSS
----------------
----------------
----------------
----------------
----------------
---------------E
--------------<>
-----------XX-[]
----------XXX-[]
------E-E-XXX-[]
XXXXXXXXXXXX--XX
