----------------
----------------
----------------
----------------
----------------
----------------
----------------
--------S-------
----------------
----------------
ooo-------------
--------S-------
----------------
----------------
----------------
XXXXXXXXXXXXXXXX
