----------------
----------------
----------------
----------------
----------------
----------------
----------------
----------------
----------------
----------------
----------------
----E-----------
---<>-----E-----
---[]----<>-----
---[]-E--[]-----
XXXXXXXXXXXXXXXX
