----------------
----------------
----------------
----------------
----------------
----------------
X-------------oo
--------------XX
----oo----------
----------------
----------------
----------------
---------XXX-?--
----------------
----------------
----XXXX-----XXX
