----------------
----------------
----------------
----------------
----------------
----------------
----------------
----------------
-------oooo-----
----------------
-----E----------
----<>----------
----[]----------
----[]----------
----[]----------
XXXXXXXXXXXXXXXX
