----------------
----------------
----------------
----------------
SSSSSSSSSSSSSSSS
SSSSSSSSSSS-----
SSSSSSSSSSS-----
SSSSSSSSSSS--QQ-
----------------
----------------
-----E-EE-------
SSSSSSSSSSS--QQ-
SSSSSSSSSSS-----
SSSSSSSSSSS-----
SSSSSSSSSSS-----
XXXXXXXXXXXXXXXX
