----------------
----------------
----------------
----------------
----------------
----------------
----------------
E-----oo--------
--------------XX
----------------
----------------
--XXXX--XXXX----
----------------
----------------
oo--------------
XX-------------X
