----------------
----------------
----------------
----------------
------------ooo-
------------XXXX
----------------
oo----XX--------
----------------
----------------
----------------
--XX-----XX-----
------------XXXX
----------------
----------------
----------------
