----------------
----------------
----------------
----------------
----------------
----------------
----------------
--------XX------
--------XX------
--------XX------
-----X--XX------
----XX--XX------
E--XXX--XX------
--XXXX----------
-XXXXX----------
XXXXXXXXXXXXXXXX
