----------------
----------------
----------------
----------------
SSS-------SSSS--
----------------
-----------?----
----------S??---
---------------X
----------------
----------------
------XXX-SSSS--
--XXX-----------
--XXX-----------
--XXX-----------
--XX------XXXX--
