----------------
----------------
----------------
----------------
----------------
----------------
oo--------------
XXX-------------
----o----E------
---XXX----------
----------------
----------------
---o----------XX
--XXXXX---------
----------------
-----------XXX--
