----------------
----------------
----------------
----------------
----------------
----------------
----------------
S------SSSS-----
----------------
----------------
----------------
QQQ-------------
----------------
----------------
EE-------------E
XXXXXXX----XXXXX
