----------------
----------------
----------------
----------------
----------------
----------------
----------------
----------------
----------------
----o------XX---
-----E-----XX---
--SSSSS----XX---
--E-------XXX---
------E---XXX---
----------XXX---
XXXXXXXXXXXXX---
