----------------
----------------
----------------
----------------
--SSSSSSSSSSSSSS
----------------
----------------
----------------
----------------
----------------
----------------
------QQQQQ-----
----------------
---------------X
----------EE-XXX
XXXXXXXXXXXXXXXX
