----------------
----------------
----------------
----------------
----------------
--------------o-
-------------XXX
----------------
--o---o---o-----
-XXX-XXX-XXX----
----------------
----------------
----------------
----------------
--------E-------
-XXXXXXXXXXXXXXX
