----------------
----------------
----------------
----------------
----------------
----------------
----------------
----------------
----------------
----------------
-XXXX------oooo-
----------------
XX--------------
----------------
----------------
----XXXXXXXXX-XX
