----------------
----------------
----------------
----------------
----------------
----------------
----------------
-------S--------
----------------
----------------
oo--------------
-------S--------
----------------
----------------
----------------
XXXXXXXXXXXXXXXX
