----------------
----------------
----------------
----------------
----------------
----------------
----------------
----------------
----------------
----------------
--E-------------
-<>-------------
-[]-----------E-
-[]----------<>-
-[]--------E-[]-
XXXX---XXXXXXXXX
