----------------
----------------
----------------
----------------
----------------
----------------
----------------
----SSSSS-----SS
E---------------
>---------------
]---------------
XX--------------
-----E------E---
----<>-----<>---
----[]-----[]---
XXXXXXXXXXXXXXXX
