----------------
----------------
----------------
----------------
----------------
----------------
----------------
----------------
----------------
----------------
----------------
---<>---------<>
---[]---------[]
---[]---------[]
---[]-----E-E-[]
XXXXXXXXXXXXXXXX
