----------------
----------------
----------------
----------------
----------------
----------------
------E---------
------E--E------
--------XXXXXX--
----------------
----------------
--XXX-----------
----------------
----------------
----------------
XX--------------
