----------------
----------------
----------------
----------------
----------------
----------------
----------------
-QQQQ-----------
----------------
----------------
----------------
Q?SSQQQ---------
----------------
----------------
----------------
XX--XXXXXXXXXXXX
