----------------
----------------
----------------
----------------
----------------
----------------
----------oooo--
----------XXXX--
oo--------------
----------------
----------------
----------------
-----XXX-?------
----------------
----------------
XXXX-----XXXXX-X
