----------------
----------------
----------------
----------------
----------------
----------------
----------------
----------------
----------------
----------------
----------------
----------------
--------------XX
-----------XXXXX
--------XXXXXXX-
XX--XXXXXXXXX---
