----------------
----------------
----------------
----------------
SSSSSSSS--------
----------------
----------XXX---
-QQ------------S
----------------
---------------S
--------------S-
-QQ--QQQ--------
----------------
----------------
----------------
XXXXXXXX------XX
