----------------
----------------
----------------
----------------
----------------
----------------
----------------
----------------
----------------
----------------
--E-------------
E<>-----E-------
>[]----<>-------
][]----[]-------
][]----[]-------
XXXXXXXXXXXXXXXX
