----------------
----------------
----------------
----------------
----------------
----------------
----------------
----------------
----------------
----------------
-E--------------
<>-----E--------
[]----<>--------
[]----[]--------
[]----[]--------
XXXXXXXXXXXXXXXX
