----------------
----------------
----------------
----------------
----------------
----------------
----------------
----------------
----------------
----------------
----------------
----------------
----------------
----------------
----EEE------EE-
XXXXXXXXXXXXXXXX
