----------------
----------------
----------------
----------------
----------------
----------------
----------------
----------------
----------------
----------------
------oooo------
-------------XXX
----------------
----------------
----------------
XXXXXXXX-XXXX---
