----------------
----------------
----------------
----------------
----------------
----------------
----------------
----------------
----------------
----------------
---o------------
---------------<
---------------[
---------------[
--------EE-E---[
XXXXXXXXXXXXXXXX
