----------------
----------------
----------------
----------------
-SSSSSSSSSSSSSSS
----------------
----------------
----------------
----------------
----------------
----------------
-----QQQQQ------
----------------
--------------XX
---------EE-XXXX
XXXXXXXXXXXXXXXX
