----------------
----------------
----------------
----------------
----------------
----------------
----------------
----------------
----------------
----------------
o---------------
----------------
----------------
-------X---X----
-------X-E-X----
--XXXXXXXXXXXXXX
