----------------
----------------
----------------
----------------
----------------
----------------
----------------
----------------
----------------
----------------
---------------E
--X-----------<>
--X-----------[]
--XX----------[]
--XX---EE-----[]
XXXXXXXXXXXXXXXX
