----------------
----------------
----------------
----------------
----------------
----------------
----------------
----------------
----------------
----------------
----------------
----------------
----------------
----------------
-EEE------EE-E--
XXXXXXXXXXXXXXXX
