----------------
----------------
----------------
----------------
-------oo-------
?-----XXXX------
----------------
----------------
--E--------XXXX-
XXXX------------
----------------
---ooo----------
-----E----------
XXXXXXX---------
----------------
----------------
