----------------
----------------
----------------
----------------
----------------
----------------
----------------
---------XXXX---
---XXX----------
----------------
-------------XXX
----------------
XXXX------------
----------------
----------------
----------------
