----------------
----------------
----------------
----------------
----------------
----------------
----------------
SS---SS---------
----------------
----------------
----------------
----SSS-------E-
-----------XX<>-
----------XXX[]-
---------XXXX[]-
X-X-XXXXXXXX-XXX
