----------------
----------------
----------------
----------------
-oo-------------
XXXX------------
----------------
----------------
-----XXXX--o---o
----------XXX-XX
----------------
----------------
----------------
X---------------
----------------
----------XXXXXX
