----------------
----------------
----------------
----------------
----------------
----------------
----------------
S---------------
----------------
----------------
----------------
XX--------------
----------------
----------------
-----------EE-E-
----XXXXXXXXXXXX
