----------------
----------------
----------------
----------------
----------------
----------------
----------------
-SSSS-----------
----------------
----------------
-------------E--
------------<>--
------------[]--
------------[]--
---------E--[]--
X----XXXXXXXXXX-
