----------------
----------------
----------------
----------------
SSSSSSSSSSSSSSSS
----SS--SSSSSS--
----SS--SSSSSS--
--SS--------SS--
--SS--------SS--
--SS--------SS--
--SS----ooooSS--
--SSSS--SSSSSS--
----SS----------
----SS----------
---E------E--E--
XXXXXXXXXXXXXXXX
