----------------
----------------
----------------
----------------
----------------
----------------
----------------
SS-----SSSSS----
----------------
----------------
----------------
-----------ES---
-----E----<>---E
----<>----[]--<>
----[]----[]--[]
XXXXXXXXXXXXXXXX
