----------------
----------------
----------------
----------------
----------------
----------------
----------------
----------------
----------------
----------------
----------------
----------------
------------X---
------------X---
E-E---------X---
XXXXXXXXXX--XXXX
