----------------
----------------
----------------
----------------
----------------
----------------
----------------
----------------
----------------
----------------
----------E--S--
---------<>-----
---------[]----<
---------[]----[
--EE-E---[]----[
XXXXXXXXXXXXXXXX
