----------------
----------------
----------------
----------------
----------------
----------------
----------------
----------------
----------------
----------------
----------------
----------------
---------X------
-----E---X------
---------X-----E
XXXXXXX--XXXXXXX
