----------------
----------------
----------------
----------------
----------------
----------------
----------------
X---------------
----------XXX---
------XXX-oo----
--------------XX
XXXXX-----------
----------------
----------------
----------------
X---------------
