----------------
----------------
----------------
----------------
----------------
----------------
----------------
----------------
----------------
----------------
----------------
-E------E-------
<>-----<>----E--
[]-----[]-------
[]-----[]-------
XXXXX--XXXXXXXXX
