----------------
----------------
----------------
----------------
SSSSSSSSSSSSSSSS
----------------
----------------
----------------
----------------
----------------
--------E-------
--E----<>-------
-<>----[]-----E-
-[]----[]----<>-
-[]----[]--E-[]-
XXXXXXXXXXXXXXXX
