----------------
----------------
----------------
----------------
----------------
----------------
----------------
----------------
---oooo---------
----------------
-E--------------
<>------------QQ
[]--------------
[]--------------
[]--------------
XXXXXXXXXXXXXXXX
