----------------
----------------
----------------
----------------
----------------
----------------
----------------
----oo----------
------------XXX-
----------------
----------------
XXXX--XXXX------
----------------
----------------
----------------
-------------XXX
