----------------
----------------
----------------
----------------
----------------
----------------
----------------
E---XXX---------
---XXXX---------
--XXXXX---------
EXXXXXX---------
>XXXXXX---------
]XXXXXX---------
]XXXXXX---------
]XXXXXX-------XX
XXXXXXXXXXXXXXXX
