----------------
----------------
----------------
----------------
----------------
----------------
----------------
---------------S
----------------
----------------
----------------
---------E----SS
--------<>------
--------[]------
--------[]------
XXXXX--XXXXXXXXX
