----------------
----------------
----------------
----------------
----------------
----------------
----------------
---SSSS---------
----------------
----------------
---------------E
--------------<>
--------------[]
--------------[]
-----------E--[]
XXX----XXXXXXXXX
