----------------
----------------
----------------
----------------
----------------
----------------
----------------
----------------
----------------
----------------
----------------
----------------
----E-----------
--------E-------
----------------
XX-X-XX-X-XX-XXX
