----------------
----------------
----------------
----------------
SSSSSSSSSSSSSSSS
----------------
----------------
----------------
----------------
----------------
----------------
----------------
-E-----SS-------
<>-----SS-------
[]-----SS-------
XXXXX--XX--XXXXX
