----------------
----------------
----------------
----------------
SSSSSS----------
----------------
--------XXX-----
----------------
----------------
----------------
-------------SSS
----XXX---------
---EXXX-XXX-----
-EXXXXX---------
-XXXXXX---------
XXXXXX-------XXX
