----------------
----------------
----------------
----------------
----------------
----------------
----------------
----------------
----------------
----------------
----------------
----------------
-X--------------
-X--------------
-X---EE-E--E----
-XXXXXXXXXXXXXXX
