----------------
----------------
----------------
----------------
----------------
----------------
----------------
----------------
----------------
----------------
----------------
----------------
E------------E--
>-----------<>--
]-----------[]--
XXXXXXXXXXXXXXXX
