----------------
----------------
----------------
----------------
----------------
----------------
----------------
----------------
----------------
----------------
----------------
----------------
----------------
----------------
E----EE-E-------
XXXXXXXXXXXXXXXX
