----------------
----------------
----------------
----------------
----------------
-------------o--
----------------
-----------SSS--
----------------
----------------
--------E-------
S------<>---S---
-------[]-------
-------[]-------
-------[]----E--
XXXXXXXXXXXXXXXX
