----------------
----------------
----------------
----------------
----------------
----------------
----------------
----------------
----------------
--o-------------
----------------
SS--------------
----------------
----------------
----------------
XXXXXXXXXXXXXXX-
