----------------
----------------
----------------
----------------
----------------
----------------
----------------
----------------
------------XXX-
----------------
----------------
----EE-E--------
-XXXXXXXXXXXX---
----------------
----------------
X---------------
