----------------
----------------
----------------
----------------
----------------
----------------
----------------
--------------SS
----------------
----------------
----------------
-------------XXX
----------XXXXX-
-------XXXXXX---
----XXXXXXX-----
XXXXXXXXX------X
