----------------
----------------
----------------
----------------
----------------
----------------
----------------
----------------
----------------
----------------
----------------
-QQQQ-----------
--------------E-
-E--------------
----------------
XXXXXXXXXXXXXXXX
