----------------
----------------
----------------
----------------
----------------
----------------
----------------
----------------
----------------
----------------
----------------
----------E-----
---------<>-----
---------[]----<
---------[]-E--[
XXXXXXXXXXXXXXXX
