----------------
----------------
----------------
----------------
----------------
----------------
----------------
----------------
----------------
----------------
----------------
E------E--------
>-----<>----E---
]-----[]--------
]-----[]--------
XXXX--XXXXXXXXXX
