----------------
----------------
----------------
----------------
----------------
----------------
----------------
----------------
----------------
----------------
----------------
----------------
----------E-----
---------<>-----
---------[]-----
XXXXXXXXXXXXXXXX
