----------------
----------------
----------------
----------------
-------------E--
oo--------------
----------------
--XXXX----------
----------------
----------------
----------------
----------------
----------------
----------------
-------------XX-
------XXXXXXXXXX
