----------------
----------------
----------------
----------------
----------------
----------------
----------------
-------------SSS
----------------
----------------
---------X------
S?S-----EX---S--
-------XXX------
------XXXX------
-----XXXXX----EE
XXXXXXXXXXXXXXXX
