----------------
----------------
----------------
----------------
-----SSSSSSSSSSS
----------------
----------------
----------------
----------------
----------------
----------------
---------QQQQQ--
----------------
----------------
-------------EE-
XXXXXXXXXXXXXXXX
