----------------
----------------
----------------
----------------
----------------
----------------
----------------
----------------
----------------
----------------
----------------
----------------
-----E----------
---------E------
----------------
XXX-X-XX-X-XX-XX
