----------------
----------------
----------------
----------------
SSSSSSSSSSSSSSSS
----------------
----------------
----------------
----------------
----------------
-------------E--
-------E----<>--
------<>----[]--
------[]----[]--
-EE---[]----[]--
XXXXXXXXXXXXXXXX
