----------------
----------------
----------------
----------------
----------------
----------------
----------------
----------------
----------------
----------------
--SSSSSSSS------
----------------
----------------
----------------
----------------
XXXXXXXXXXXXXXX-
