----------------
----------------
----------------
----------------
----------------
----------------
----------------
--SSSS----------
----------------
----------------
----------------
--S-----X-------
--------X-------
--------XX------
---EE---XX---EE-
XXXXXXXXXXXXXXXX
