----------------
----------------
----------------
----------------
----------------
----------------
----------------
----------------
-----E----------
----<>----------
----[]----------
----[]------E---
--E-[]-----<>---
-<>-[]-----[]---
-[]-[]-----[]---
XXXXXXXXXXXXXXXX
