----------------
----------------
----------------
----------------
----------------
----------------
----------------
----E-----oo----
----------------
XX--------------
----------------
------XXXX--XXXX
----------------
----------------
---ooo----------
---XXX----------
