----------------
----------------
----------------
----------------
----------------
----------------
----------------
----------------
----------------
----------------
----------------
---QQ-----------
----------------
----------------
-------------XXX
XXXXXXX--XXXXXXX
