----------------
----------------
----------------
----------------
----------------
----------------
----------------
----------------
----------------
----------------
-----------ooo--
---------E------
S-------<>------
--------[]------
--------[]------
--XXXXXXXXXXXXXX
