----------------
----------------
----------------
----------------
----------------
----------------
----------------
-----E---XXX----
--------XXXX----
-------XXXXX----
-----EXXXXXX----
----<>XXXXXX----
----[]XXXXXX----
---X[]XXXXXX----
--XX[]XXXXXX----
XXXXXXXXXXXXXXXX
