----------------
----------------
----------------
----------------
SSSSSSSSSSSSSSSS
-------SS--SSSSS
-------SS--SSSSS
-----SS--------S
-----SS--------S
-----SS--------S
-----SS----ooooS
-----SSSS--SSSSS
-------SS-------
-------SS-------
------E------E--
XXXXXXXXXXXXXXXX
