----------------
----------------
----------------
----------------
----------------
----------------
----------------
--SQS-----------
----------------
---------------o
----------------
--S?S--------SSS
----------E--E--
----------------
-E--------------
XXXXXXXXXXXXXXXX
