----------------
----------------
----------------
----------------
SSSSSSSSSSSSSSSS
-----------SS--S
-----------SS--S
oo-------SS-----
---------SS-----
SS-S-----SS-----
-SoS-----SS----o
-SSS-----SSSS--S
-----------SS---
-----------SS---
E---------E-----
XXXXXXXXXXXXXXXX
