----------------
----------------
----------------
----------------
----------------
----------------
----------------
--------------XX
-------------XXX
---X--------XXXX
--XX-------XXXXX
-XXX------XXXXXX
XXXX-----XXXXXXX
XXXX----XXXXXXXX
XXXX---XXXXXXXXX
XXXXXXXXXXXXXXXX
