----------------
----------------
----------------
----------------
----------------
----------------
----------------
----------------
----------------
----------------
----------------
----------------
----------------
----------------
E--E-EE-------EE
XXXXXXXXXXXXXXXX
