----------------
----------------
----------------
----------------
----------------
----------------
----------------
-----XX---------
----XXX---------
---XXXX---------
--XXXXX---------
-XXXXXX---S-----
XXXXXXX---------
XXXXXXX---------
XXXXXXX--------X
XXXXXXXXXXXXXXXX
