----------------
----------------
----------------
----------------
SSSSSSSSSSSSSSSS
----------------
----------------
----------------
----------------
----------------
----------------
----------------
----SS----------
----SS---------E
----SS---------X
XX--XX--XXXXXXXX
