----------------
----------------
----------------
----------------
----------------
----------------
----------------
----------------
----------------
----------------
----------------
-------ooo------
----------------
---------------X
--------------XX
XX--XXXXXXXXXXXX
