----------------
----------------
----------------
----------------
----------------
----------------
----------------
----------------
----------------
----------------
----------------
----------------
--------------X-
--------------X-
--------------X-
--XXX--XXXXXXXX-
