----------------
----------------
----------------
----------------
----------------
----------------
--------------Eo
--------------XX
----------------
----------------
----------------
------------XXXX
----------------
----------------
------XXXX------
XXXX------------
