----------------
----------------
----------------
----------------
----------------
----------------
----------------
-----------SSS--
----------------
----------------
----------------
-----E-XX--SSS--
--XX<>-XX-------
-XXX[]-XXX------
XXXX[]-XXX------
XXX-XXXXXXXXXXXX
