----------------
----------------
----------------
----------------
-?--------------
----------------
----------------
----------------
---SS-----------
--------X-------
S------XX-------
------XXX------X
-----XXXX-----XX
----XXXXX----XXX
---XXXXXX---XXXX
XX-XXXXXXXXXXXXX
