----------------
----------------
----------------
----------------
----------------
----------------
----------------
------SSSS------
----------------
----------------
------------E---
-----S-----<>---
-----------[]---
-----------[]---
-E--EE-E---[]---
XXXXXXXXXXXXXXXX
