----------------
----------------
----------------
----------------
SSSSSSSSSSSSSSSS
----------------
----------------
----------------
----------------
----------------
----------------
-QQQQQ--------XX
------------XXXX
----------XXXXXX
-----EE-XXXXXXXX
XXXXXXXXXXXXXXXX
