----------------
----------------
----------------
----------------
----------------
----o-----------
---XXX----------
-------o------o-
o------XXXX-----
XX--------------
--------------XX
----------------
----------------
----------XXXX--
----------------
XXXXXXX---------
