----------------
----------------
----------------
----------------
----------------
----------------
----------------
----?SSS--------
----------------
----------E-----
--E------<>-----
-<>---E--[]-----
-[]--<>--[]-----
-[]--[]--[]-----
-[]--[]--[]-----
XXXXXXXXXXXXXXXX
