----------------
----------------
----------------
----------------
----------------
----------------
----------------
X-----oo--XXXX--
-----XX---------
----------------
----------------
--------XX---XXX
----------------
----------------
----------------
-XXXX-----XXXX--
