----------------
----------------
----------------
----------------
----------------
----------------
----------------
S--SQS----------
----------------
----------------
----------------
S--S?S--------SS
-----------E--E-
----------------
--E-------------
XXXXXXXXXXXXXXXX
