----------------
----------------
----------------
----------------
----------------
----------------
----------------
--E-------------
-<>-------------
-[]-------------
-XXX------------
---------------<
-----E-E-------[
----<><>-------[
----[][]-------[
XXXXXXXXXXXXXXXX
