----------------
----------------
----------------
--------------XX
SSSSSSSSSSSSS---
----------------
----------------
----------------
----------------
----------------
-E--------------
<>--------------
[]----------XX--
[]---------XXXXX
[]--------XXXX--
XX--XXXXXXXXX---
