----------------
----------------
----------------
----------------
----------------
----------------
----------------
----------------
----------------
----------------
----------o-----
----------------
----------------
----------------
-----E---------E
-XX-XXXXXXXXXXXX
