----------------
----------------
----------------
----------------
----------------
----------------
----------------
----------------
----------------
----------------
---------E------
-E------<>------
<>------[]--E---
[]------[]-<>---
[]------[]-[]---
XXXXXXXXXXXXXXXX
