----------------
----------------
----------------
----------------
----------------
----------------
----------------
---SSSSS--------
----------------
----------------
----E-----------
---SSSSS--------
----------X-----
----------X-----
----------X-----
XXXXXXXXXXXXXXXX
