----------------
----------------
----------------
----------------
SSSSSSSSSSSSSSSS
SSSSSSSSSSSSSSSS
SSSSSSSSSSSSSSSS
SSSSSSSSSSSSSSSS
----------------
----------------
------?---------
SSSSSS??SSSSSSSS
SSSSS---SSSSSSSS
SSSSS---SSSSSSSS
-----oooSSSSSSSS
XXXXXXXXXXXXXXXX
