----------------
----------------
----------------
----------------
----------------
----------------
----------------
----------------
----------------
----------------
----------------
--------------XX
----------------
----------------
----------------
XXXXXXXXX--XXXX-
