----------------
----------------
----------------
----------------
----------------
----------------
----------------
----------------
----------------
----------E----<
E--------<>----[
>---SS---[]----X
]--------[]-----
]--------[]-----
]--------[]-----
XXXXXXXXXXXXXXXX
