----------------
----------------
----------------
----------------
----------------
----------------
----------------
----------------
----------------
----------------
----------------
----------------
-----------X----
-----------X----
-E---------X---E
XXXXXXXXX--XXXXX
