----------------
----------------
----------------
----------------
----------------
----------------
----------------
?SS-------------
----------------
----------------
----------------
------------QQQQ
----------------
------------E---
----------------
XXXXXXXXXXXXXXXX
