----------------
----------------
----------------
----------------
----------------
----------------
----------------
-------------SSS
----------------
----------------
----------------
----------S---E-
---X------------
---X------------
---X-----EE-----
X--XXXXXXXXXXXXX
