----------------
----------------
----------------
----------------
----------------
----------------
-------ooooooo--
----XX----------
----------------
----------XX----
----------------
----------------
----------------
-------------XXX
----------------
-XXXX--XXXX-----
