----------------
----------------
----------------
----------------
----------------
----------------
----------------
----------E-----
--E-------------
XXXXXXXX--------
----------------
------------XXXX
----------------
----------------
---------ooo----
---------XXX----
