----------------
----------------
----------------
----------------
----------------
----------------
----------------
----------------
------XSSS------
-----XXX--------
----XXXS--------
----XXXX--------
--XXXXXX-SSS----
-XXXXXXX--------
----XXXX--------
XXXXXXXXXX---XXX
