----------------
----------------
----------------
----------------
SSSSSSSSSSSSSSSS
SSSS------SSSS--
SSSS--E---SSSS--
-S----SS--------
-S----SS--------
-S----SS--------
-So??-SS---E----
-SSS--SS--SSSS--
---------EE-----
----------------
----------------
XXXXXXXXXXXXXX--
