----------------
----------------
----------------
----------------
----------------
----------------
----------------
----------------
----------------
----------------
----E-----------
---<>-----------
---[]-----------
---[]----------<
E--[]--------E-[
XXXXXX---XXXXXXX
