----------------
----------------
----------------
----------------
-----oo---------
----XXXX--------
----------------
----------------
E--------XXXX--o
XX------------XX
----------------
-ooo------------
---E------------
XXXXX-----------
----------------
--------------XX
