----------------
----------------
----------------
----------------
----------oo----
----------------
----------------
----------XXX---
----------------
----------------
----------------
---XXXX------XXX
----------------
----------------
----------------
XXXX--XXXX------
