----------------
----------------
----------------
----------------
----------------
----------------
----------------
----o-o----XXX--
X---------------
----------------
----XXXX--------
---------XXX-XXX
----------------
XXXX------------
----------------
----------------
