----------------
----------------
----------------
----------------
SSSSSSSSSSSSSSSS
----------------
----------------
----------------
----------------
----------------
------------E---
--------E--<>---
-E-----<>--[]---
<>-----[]--[]---
[]---E-[]--[]---
XXXXXXXXXXXXX--X
