----------------
----------------
----------------
----------------
SSSSSSSSSSSSSSSS
----------------
----------------
----------------
----------------
----------------
----------------
----------------
--SS-----------E
--SS---------EXX
--SS---------XXX
--XX--XXXXXXXXXX
