----------------
----------------
----------------
----------------
----------------
----------------
----------------
----------------
----------------
----------------
-----E----------
----<>----------
----[]----------
----[]----------
-E--[]----E-E---
XXXXXXXXXXXXXXX-
