----------------
----------------
----------------
----------------
----------------
----------------
----------------
----------------
----------------
----------------
----------------
----------------
-----------X----
-----------X----
-----------X----
XX--XXXXXXXX--XX
