----------------
----------------
----------------
----------------
----------------
----------------
----------------
SS--------------
----------------
----------------
-------------E--
------------<>--
----------------
----------------
--E-E---E-------
XXXXXXXXXXXXXXXX
