----------------
----------------
----------------
----------------
----------------
----------------
----------------
---------SSSSS--
----------------
----------------
----------E-----
---------SSSSS--
----E-----------
---<>-----------
---[]-----------
XXXXXXXXXXXXXXXX
