----------------
----------------
----------------
----------------
----------------
----------------
----------------
----------------
----------------
----------------
----------E-----
---------<>----E
---------[]-----
---------[]-----
--EE-----[]-----
XXXXXXXXXXXXXXXX
