----------------
----------------
----------------
----------------
----------------
----------------
----------------
----------------
-------XSSS-----
------XXX-------
-----XXXS-------
-----XXXX-------
---XXXXXX-SSS---
--XXXXXXX-------
-----XXXX-------
XXXXXXXXXXX---XX
