----------------
----------------
----------------
----------------
---------?------
----------------
----------------
----------------
-----------SS---
----------------
-------SS------X
--------------XX
-------------XXX
------------XXXX
-----------XXXXX
XXXXXXXXXX-XXXXX
