----------------
----------------
----------------
----------------
----------------
----------------
----------------
-------------SSS
----------------
----------------
----------------
-------E-XX--SSS
----XX<>-XX-----
---XXX[]-XXX----
--XXXX[]-XXX----
XXXXX-XXXXXXXXXX
