----------------
----------------
----------------
----------------
----------------
----------------
----------------
-----SSS-----E--
------------<>--
------------[]--
------------[]--
-XX--SSS----XXX-
-XX-------------
-XXX------------
-XXX--------E---
XXXXXXXXXXXXXXXX
