----------------
----------------
----------------
----------------
----------------
----------------
----------------
------------?SS-
----------------
----------------
----------------
----------------
---------E------
----------------
----------------
XXXXXXXXXXXXXXXX
