----------------
----------------
----------------
----------------
----------------
----------------
----------------
----------------
----------------
----------------
----------------
----------------
---X------------
---X------------
---X------------
XXXX--XXXXXXXXXX
