----------------
----------------
----------------
----------------
----------------
---------o------
----------------
-------SSS------
----------------
----------------
----E--------E--
---<>---S---<>--
---[]-------[]--
---[]-------[]--
---[]----E--[]--
XXXXXXXXXXXXXXXX
