----------------
----------------
----------------
----------------
----------------
----------------
----------------
------------E---
---------------X
--------------XX
------------EXXX
E----------<>XXX
>----------[]XXX
]---------X[]XXX
]--------XX[]XXX
XXXXXXXXXXXXXXXX
