----------------
----------------
----------------
----------------
----------------
----------------
----------------
-------QQQQQ----
----------------
----------------
-E--------------
<>----E?QQQQ----
[]--------------
[]--------------
[]-----------E-E
XXXXXXXXXXXXXXXX
