----------------
----------------
----------------
----------------
----------------
----------------
----------------
SS------SSSS----
----------------
----------------
----------------
-QQQ------------
----------------
----------------
-EE-------------
XXXXXXXX----XXXX
