----------------
----------------
----------------
----------------
----------------
----------------
-E--------------
SSS----S--------
----------------
----------------
----------------
SSS-----E-------
-------<>-------
-------[]-------
-------[]-------
XXXXXXXXXXXXXXXX
