----------------
----------------
----------------
----------------
----------------
----------------
----------------
----------------
----------------
-E--------------
<>--------------
[]--------------
[]--------------
[]--------------
[]--------------
XXXXXXXXX---XXXX
