----------------
----------------
----------------
----------------
----------------
----------------
----------------
----------------
----------------
----------oo----
----------------
------XXX-------
-----XXXX-------
----XXXXX-------
---XXXXXX-------
XXXXXXXX---XXXXX
