----------------
----------------
----------------
----------------
----------------
----------------
----------------
--S-------------
----------------
----------------
----------------
---E------------
--<>------------
--[]------------
--[]------------
XXXXXXXXXXXXXXXX
