----------------
----------------
----------------
----------------
SSSSSSSSSSSSSSSS
----------------
----------------
------------oooo
-o--------------
----------S-SSSS
S---------SoS--S
----------SSS--S
--XX------------
--XXXX----------
E-XXXX-------EE-
XXXXXXXXXXXXXXXX
