----------------
----------------
----------------
----------------
----------------
----------------
----------------
------------SSS-
----------------
----------------
----------------
------E----XXXXX
------E----X----
-----------X----
-----------X----
XXXXXXXXXXXXXX--
