----------------
----------------
----------------
----------------
----------------
---------------o
----------------
-------------SSS
----------------
----------------
----------E-----
SSS------<>---S-
---------[]-----
---------[]-----
---------[]----E
XXXXXXXXXXXXXXXX
