----------------
----------------
----------------
----------------
SSSSSSSSSSSS----
----------------
--------------XX
----------------
----------------
----------------
----------------
----------XXX---
---------EXXX-XX
-------EXXXXX---
-------XXXXXX---
XXXXXXXXXXXX----
