----------------
----------------
----------------
----------------
----------------
----------------
----------------
--SS------------
----------------
----------o-----
----------------
-XXXX--SSS------
XXX-------------
X---------------
----------------
---XX--XXXXXXXXX
