----------------
----------------
----------------
----------------
----------------
----------------
----------------
---------XX-----
---------XX-----
-------XXXX-----
-------XXXX-----
-----XXXXXX-----
-----XXXXXX-----
-----XXXXXX-----
-E---XXXXXX-----
XXXXXXXXXXXXXXXX
