----------------
----------------
----------------
----------------
----------------
----------------
----------------
----------------
----------------
----------------
o-----E--o------
-----<>--------<
-----[]--------[
-----[]--------[
-----[]--------[
XXXXXXXXXXXXXXXX
