----------------
----------------
----------------
----------------
SSSSSSSSSSSSSSSS
----------------
----------------
---E------------
--<>------------
--[]------------
--[]-------S----
SS[]SS---E----E-
--[]----<>---<>-
--[]----[]---[]-
--[]----[]---[]-
XXXXXXXXXXXXXXXX
