----------------
----------------
----------------
----------------
S-----SSSSSSSSSS
----------------
----------------
----------------
--XXX-----------
----------------
----------------
S---------------
----------E-----
---------<>-----
---------[]---E-
X------XXXXXXXXX
