----------------
----------------
----------------
----------------
----------------
----------------
----------------
----------------
----------oooo--
----------------
----------------
----------------
--------X-------
--------X-------
--------X-------
XXXXXXXXXXXXXXXX
