----------------
----------------
----------------
----------------
----------------
--------------Q-
--ooooooo-------
X---------------
------------XX--
-----XX---------
----------------
----------------
----------------
--------XXXXX---
----------------
--XXXX----------
