----------------
----------------
----------------
----------------
----------------
----------------
----------------
----------------
----------------
----------------
----------------
----------------
----------------
S---------------
---------------X
-XXXXXXXXX---XXX
