----------------
----------------
----------------
----------------
---SSSS-----SSSS
----------------
----?-----------
---S??----------
--------XXX-----
----------------
----------------
XX-SSSS---------
----------------
---------------<
---------------[
---XXXX------XXX
