----------------
----------------
----------------
----------------
----------------
----------------
oo--------------
----------------
----------------
----------------
----------------
----------------
-------E--------
------<>--------
EE----[]-E-----E
XXXXXXXXXXXXXXXX
