----------------
----------------
----------------
----------------
----------------
----------------
----------------
----------------
----------------
----------------
------E--------E
X----<>------E<>
-----[]----E<>[]
-----[]---<>[][]
-----[]---[][][]
XXXXXXXXXXXXXXXX
