----------------
----------------
----------------
----------------
--------------?-
----------------
----------------
SS--------------
----------------
----------------
------------SS--
SS--------------
----X-----------
----X-----------
----X-----------
XXXXXXXXXXXXXXX-
