----------------
----------------
----------------
----------------
----------------
----------------
----------------
-------------XXX
------------XXXX
-----------EXXXX
----------XXXXXX
---------XXXXXXX
-------EXXXXXXXX
-------XXXXXXXXX
------XXXXXXXXXX
---XXXXXXXXXXXXX
