----------------
----------------
----------------
----------------
----------------
----------------
----------------
---?------------
----------------
----------------
----------------
--------E-------
-E-----<>-------
-------[]-------
-------[]E------
XXXXXXXXXXXXXXXX
