----------------
----------------
----------------
----------------
----------------
----------------
----------------
------SSS-------
----------------
----------------
------SSS-------
----------------
---------------X
--------------XX
-------------XXX
XXXXX----XXXXXXX
