----------------
----------------
----------------
----------------
----------------
----------------
----------------
Q---------------
----------------
----------------
----------------
Q---------------
----------------
----------------
----------------
XXXXXXXXXXXX----
