----------------
----------------
----------------
----------------
o---------------
---E--E---------
--XXXXXXX-------
----------------
------------oo--
----------------
XX--------------
----------------
----------------
----------------
----------------
------------XXXX
