----------------
----------------
----------------
----------------
----------------
----------------
----------------
----------------
----------------
--------E-------
----E--<>-------
E--<>--[]-------
>--[]--[]-------
]--[]--[]-------
]--[]--[]-------
X--XX--XXXXXXXXX
