----------------
----------------
----------------
----------------
----------------
----------------
----------------
----------------
----------------
----------------
----------------
-E--------------
<>-----E--------
[]----<>--------
[]-E--[]--------
XXXXXXXXXXXXXXXX
