----------------
----------------
----------------
----------------
----------------
----------------
----------E-----
------SSSSSS----
----------------
----------------
-------E--------
E----SSSSSSS----
>---------------
]---------------
]---------------
XXXXXXXXXXXXXXXX
