----------------
----------------
----------------
----------------
----------------
----------------
----------------
----------------
----------------
----------------
----------------
-------------ooo
----------------
----------------
----------------
XXXXXXXX--XXXXXX
