----------------
----------------
----------------
----------------
----------------
----------------
----------------
-----E-----oo---
----------------
XXX-------------
----------------
-------XXXX--XXX
----------------
----------------
----ooo---------
----XXX---------
