----------------
----------------
----------------
----------------
------oo--------
----------------
----------------
------XXX-------
----------------
----------------
----------------
XXX------XXXXX--
----------------
----------------
----------------
--XXXX---------X
