----------------
----------------
----------------
----------------
----------------
----------------
----------------
----------------
--XX------------
--------------XX
--------------XX
------------XXXX
------------XXXX
------------XXXX
--------E---XXXX
---XXXXXXXXXXXXX
