----------------
----------------
----------------
----------------
o---------------
XX--------------
----------------
----------------
---XXXX--o---o--
--------XXX-XXX-
----------------
----------------
----------------
----------------
---------------E
--------XXXXXXXX
