----------------
----------------
----------------
----------------
----------------
----------------
----------------
QQQQ------------
----------------
----------------
----------------
?SSQQQ----------
----------------
---------------<
---------------[
X--XXXXXXXXXXXXX
