----------------
----------------
----------------
----------------
----------------
----------------
----------------
----------------
----------------
----------------
----------------
----------------
----------------
----------------
----EE-E--E-----
XXXXXXXXXXXXXXXX
