----------------
----------------
----------------
----------------
----------------
----------------
----------------
----------------
-------o----ooo-
----------------
-XXX------------
-------------XXX
----------------
----------------
-oo---XXXXXXX---
XXX-------------
