----------------
----------------
----------------
----------------
----------------
--------Q-------
ooo----------XXX
----------------
------XX--------
X---------------
----------------
----------------
----------------
--XXXXX---------
----------------
----------------
