----------------
----------------
----------------
----------------
----------------
----------------
----------------
----------------
----------------
----------------
----------------
------E---------
-----<>---------
-----[]---------
-EE--[]---------
XXXXXXXXXXXXXXXX
