----------------
----------------
----------------
----------------
SSSSSSSSSSSSS---
SSSS------------
SSSS-----------X
SSSS--QQ--------
----------------
----------------
EE--------------
SSSS--QQ--QQQ---
SSSS------------
SSSS------------
SSSS------------
XXXXXXXXXXXXX---
