----------------
----------------
----------------
----------------
----------------
----------------
----------------
--------XXX-----
---------------X
----------------
----------------
X---------------
----------------
----------------
----------------
-XXXXXX----XXXX-
