----------------
----------------
----------------
----------------
----------------
----------------
----------------
?SSS------------
----------------
------E---------
-----<>---------
--E--[]---------
-<>--[]---------
-[]--[]---------
-[]--[]---------
XXXXXXXXXXXXXX--
