----------------
----------------
----------------
----------------
----------------
---------oo-----
----------------
-----------XXXX-
XXX-------------
oo--------------
----XXX---------
----------------
----------------
----------------
----------------
---------------X
