----------------
----------------
----------------
----------------
----------------
----------------
----------------
----------------
----------------
----------------
------------E---
SS----E----<>---
-----<>---------
----------------
----------E-----
XXXXXXXXXXXXXXXX
