----------------
----------------
----------------
----------------
----------------
----------------
----------------
----------------
oooo----------oo
----------------
------------E---
-----------<>---
-----------[]---
-----------[]---
-----------[]---
XXXXXXXXXXXXXXXX
