----------------
----------------
----------------
----------------
SSSSSSSSSSSSSSSS
SSSSSSSS--------
SSSSSSSS--------
SSSSSSSS--QQ----
----------------
----------------
--E-EE----------
SSSSSSSS--QQ--QQ
SSSSSSSS--------
SSSSSSSS--------
SSSSSSSS--------
XXXXXXXXXXXXXXXX
