----------------
----------------
----------------
----------------
----------------
----------------
----------------
----------------
----------------
---------------X
---------------X
-------------X-X
-------E-----X-X
------<>---X-X-X
------[]---X-X-X
XXXXXXXXXX-X-X-X
