----------------
----------------
----------------
----------------
----------------
----------------
----------------
----------------
----------------
----------------
----------------
------QQ--------
----------------
----------------
----------------
XXXXXXXXXX--XXXX
