----------------
----------------
----------------
-XXX------------
-----SSSSSSSSSSS
-----SSSSSSSSSSS
-----SSSSSSSSSSS
-----SSSSSSSSSSS
-----S----------
-----S----------
------?ooooooooo
------??SSSSSSSS
X---------------
XXXX------------
X------------EE-
-----XXXXXXXXXXX
