----------------
----------------
----------------
----------------
SSSSSSSSSSS-----
----------------
-------------XXX
----------------
----------------
----------------
----------------
---------XXX----
--------EXXX-XXX
------EXXXXX----
------XXXXXX----
XXXXXXXXXXX-----
