----------------
----------------
----------------
----------------
-oo-------------
----------------
----------------
-XXX---------XX-
----------------
----------------
----------------
----XXXXX-------
----------------
----------------
----------------
X---------XXXX--
