----------------
----------------
----------------
----------------
----------------
----------------
----------------
----------------
----------------
----------------
-----------E----
S----E----<>----
----<>----------
----------------
---------E------
XXXXXXXXXXXXXXXX
