----------------
----------------
----------------
----------------
SSSSSSSSSSSSSSSS
----------------
----------------
----------------
----------------
----------------
------------E---
------E----<>---
-----<>----[]---
-----[]----[]---
EE---[]----[]--E
XXXXXXXXXXXXXXXX
