----------------
----------------
----------------
----------------
----------------
----------------
----------------
----------------
----------------
----------------
-o------------E-
-------------<>-
-------------[]-
-------------[]-
------EE-E---[]-
XXXXXXXXXXXXXXXX
