----------------
----------------
----------------
----------------
----------------
----------------
----------------
----------------
---------------X
-XX-----------EX
-XX----------XXX
-XX---------XXXX
XXX-------EXXXXX
XXX-------XXXXXX
XXX------XXXXXXX
XXX---XXXXXXXXXX
