----------------
----------------
----------------
----------------
----------------
----------------
----------------
----------------
----------------
----------------
-------------o--
----------------
----------------
----------------
--------E-------
-XX-XX-XXXXXXXXX
