----------------
----------------
----------------
----------------
----------------
------o---------
----------------
----SSS-------E-
-------------<>-
-------------[]-
-E--------E--XXX
<>---S---<>-----
[]-------[]-----
[]-------[]-----
[]----E--[]-----
XXXXXXXXXXXXXXXX
