----------------
----------------
----------------
----------------
SSSSSSSSSSSSSSSS
----------------
----------------
------oooo------
----------------
----S-SSSS-S----
----SoS--SoS----
----SSS--SSS----
----------------
----------------
-------EE-------
XXXXXXXXXXXXXXXX
