----------------
----------------
----------------
----------------
----------------
----------------
----------------
---------Q------
----------------
----------------
----------------
------E--?------
-----<>---------
-----[]---------
-----[]---------
XXXXXXXXXXXXXXXX
