----------------
----------------
----------------
----------------
----------------
----------------
----------------
--XX------------
--XX------------
X-XX------------
X-XX------------
X-XX------------
X-XX------------
X-XX------------
X-XX--------X---
X-XXXXXXXXXXXXXX
