----------------
----------------
----------------
----------------
----------------
----------------
----------------
----------XXXX--
----XXX---------
----------------
--------------XX
----------------
XXXXX-----------
----------------
----------------
----------------
