----------------
----------------
----------------
----------------
----------------
----------------
----------------
----------------
----------------
----------------
---------------o
----------------
----------------
----------------
----------E-----
XX-XX-XX-XXXXXXX
