----------------
----------------
----------------
----------------
----------------
----------------
----------------
------------SSSS
----------------
----------------
----------------
---------S---E--
--X-------------
--X-------------
--X-----EE------
--XXXXXXXXXXXXXX
