----------------
----------------
----------------
----------------
----------------
----------------
----------------
----------------
----------------
----------------
---oo-----------
----------------
----------------
----------------
------------EE-E
X------XXXXXXXXX
