----------------
----------------
----------------
----------------
SSSSSSSSSSSSSSSS
SSSSSSSSSSSSSSSS
SSSSSSSSSSSSSSSS
SSSSSSSSSSSSSSSS
----------------
----------------
-------?--------
-SSSSSS??SSSSSSS
-SSSSS---SSSSSSS
-SSSSS---SSSSSSS
------oooSSSSSSS
XXXXXXXXXXXXXXXX
