----------------
----------------
----------------
----------------
----------------
----------------
----------------
----------------
----------------
----------------
------------o---
----------------
----------------
----------------
-------E--------
XX-XX-XXXXXXXXXX
