----------------
----------------
----------------
----------------
----------------
--------------XX
--------------XX
----------S---XX
--------------XX
--------------XX
--------------XX
-E-------SS---XX
<>------------XX
[]------------XX
[]E-----------XX
XXXXXXXXXXXXXXXX
