----------------
----------------
----------------
----------------
----------------
----------------
----------------
-----XXXX-------
XX--------------
----------------
---------XXXX---
----------------
----------------
----------------
----------------
-------------XXX
