----------------
----------------
----------------
----------------
SSSSSSSSSSSSSSSS
----------SSSSSS
----------SSSSSS
----------SSSSSS
----------------
----------------
----------------
------------SSSS
------------SSSS
------------SSSS
----------------
X--XX--X---XXXXX
