----------------
----------------
----------------
----------------
----------------
----------------
----------------
S------------SS-
----------------
----------------
-----------SS---
----------------
-----E---E------
----<>--<>------
----[]--[]------
--XXXXXXXXXXXX-X
