----------------
----------------
----------------
----------------
----ooo---------
----XXXX--------
----------------
----------------
----------------
----------------
---------XXXX---
-XX-------------
----XXXXXX------
----------------
----------------
------------XXXX
