----------------
----------------
----------------
----------------
----------------
----------------
----------------
----------------
-E--------------
<>--------------
[]--------------
XX--------------
--------E-------
-------<>-------
-------[]-------
XXXXXXXXXXXXXXXX
