----------------
----------------
----------------
----------------
----------------
----------------
----------------
SS--------------
----------------
----E-----------
---<>-----------
E--[]-----------
>--[]-----------
]--[]-----------
]--[]-----------
XXXXXXXXXXXX---X
