----------------
----------------
----------------
----------------
----------------
----------------
----XX----------
----------------
--E----------o--
XXXX------------
-------XXX------
----------------
----------------
----------------
-------oo---XXXX
------XXX-------
