----------------
----------------
----------------
----------------
----------------
----------------
----------------
------XXoo----XX
----------------
----------------
----------------
XXXXXX----XX----
----------------
----------------
----------------
----------------
