----------------
----------------
----------------
----------------
SSSSSSSSSSSSSSSS
---------------S
---------------S
--oooo-------SS-
-------------SS-
S-SSSS-S-----SS-
SoS--SoS-----SS-
SSS--SSS-----SSS
---------------S
---------------S
---EE---------E-
XXXXXXXXXXXXXXXX
