----------------
----------------
----------------
----------------
SSSSSSSSSSSSSSSS
SSSSSSSSSSSSSSSS
SSSSSSSSSSSSSSSS
SSSSSSSSSSSSSSSS
----------------
----------------
-?-------------E
S??SSSSSSSSSSSSS
---SSSSSSSSSSSSS
---SSSSSSSSSSSSS
oooSSSSSSSSSSSSS
XXXXXXXXXXXXXXXX
