----------------
----------------
----------------
----------------
----------------
----------------
----------------
----------------
------------E---
------E----<>---
-----<>----[]---
SS---[]----XXX--
-----[]---------
-----[]---------
-----[]---------
XXXXXXXXXXXXXXXX
