----------------
----------------
----------------
----------------
----------------
----------------
----------------
----------------
----------------
----------------
----------------
--------QQQQ----
----------------
--------E-------
----------------
XXXXXXXXXXXXXXXX
