----------------
----------------
----------------
----------------
----------------
----------------
----------------
--SSSSSSSS------
----------------
----------------
----------------
-X----S----X----
-X------E--X----
-X---------X----
-X---------X----
XXXXXXXXXXXXXXXX
