----------------
----------------
----------------
----------------
----------------
----------------
----------------
----------------
----------------
----------------
----------------
-----E--S-------
----<>---------E
--------------<>
-E-----E--------
XXXXXXXXXXXXXXXX
