----------------
----------------
----------------
----------------
----------------
----------------
----------------
-------S-------S
----------------
----------------
------E-EE------
-X--------XX-XX-
XXX-------XX-XX-
XXX-------XX-XXX
XX--------X--XXX
XX--------X--XXX
