----------------
----------------
----------------
----------------
----------------
----------------
----------------
----------------
----------------
----------------
----------------
--SSXSS---------
----------------
----------------
----------------
XXXXXXXXXXXXX--X
