----------------
----------------
----------------
----------------
----------------
----------------
----------------
----------------
----------------
----------------
----------------
>---------<>----
]---------[]----
]---------[]----
]-----E-E-[]----
XXXXXXXXXXXXXXXX
