----------------
----------------
----------------
----------------
----------------
----------------
----------------
----------------
----E-----------
X---------------
----------------
------------EE-E
---------XXXXXXX
XX--------------
----------------
------XXX-------
