----------------
----------------
----------------
----------------
----------------
----------------
----------------
-------E--S---SS
------<>--------
------[]--------
------[]--------
-----SXXS-------
-E---------E----
<>--------<>----
[]--------[]----
XXXXXXXXXXXXXXXX
