----------------
----------------
----------------
----------------
SSSSSSSSSSSSSSSS
----------------
----------------
-E--------------
<>--------------
[]--------------
[]-------S------
[]SS---E----E---
[]----<>---<>---
[]----[]---[]---
[]----[]---[]---
XXXXXXXXXXXXXXXX
