----------------
----------------
----------------
----------------
SSSSSSSSSSSSSSSS
---------SS--SSS
---------SS--SSS
-------SS-------
-------SS-------
-S-----SS-------
oS-----SS----ooo
SS-----SSSS--SSS
---------SS-----
---------SS-----
--------E------E
XXXXXXXXXXXXXXXX
