----------------
----------------
----------------
----------------
----------------
----------------
----------E-----
---------SQS--SQ
----------------
XX--------------
XX--------------
XX-------SQS--S?
XX--------------
XX--------------
XX-----E-----E--
X--XXXXXXXXXXXXX
