----------------
----------------
----------------
X---------------
--SSSSSSSSSSSSSS
--SSSSSSSSSSSSSS
--SSSSSSSSSSSSSS
--SSSSSSSSSSSSSS
--S-------------
--S-------------
---?oooooooooo--
---??SSSSSSSSS--
----------------
X---------------
----------EE---X
--XXXXXXXXXXXXXX
