----------------
----------------
----------------
----------------
----------------
----------------
----------------
----------------
----------------
----XX----------
----XX----------
----XX---------X
---XXX-------EXX
---XXX-------XXX
---XXX------XXXX
XXXXXX---XXXXXXX
