----------------
----------------
----------------
----------------
-----------?----
----------------
----------------
----------------
-------------SS-
----------------
---------SS-----
----------------
-X-------------X
-X------------XX
-X-----------XXX
XXXXXXXXXXXX-XXX
