----------------
----------------
----------------
----------------
----------------
----------------
o----------E----
X----------E--E-
-------------XXX
----------------
----------------
-------XXX------
----------------
----------------
----------------
X-XXXXX---------
