----------------
----------------
----------------
----------------
----------------
----------------
----------------
----------------
----------------
----------------
----------------
----------------
-----------E----
----------<>----
----------[]----
XXXXXXXXXXXXXXXX
