----------------
----------------
----------------
----------------
----------------
----------------
----------------
SSSSS-----------
-----------E----
----------<>----
----------[]----
----ES----[]----
---<>---E-[]----
---[]--<>-[]----
---[]--[]-[]----
XXXXXXXXXXXXXXXX
