----------------
----------------
----------------
----------------
----------------
----------------
----------------
SS?SSS--------SS
----------------
----------------
--------------SS
SSSSSSS---------
----------------
----------------
----------------
XXXXXXXXXXXXX---
