----------------
----------------
----------------
----------------
----------------
----------------
----------------
----------------
----------------
----------------
----------E-----
--E------<>-----
-<>------[]--E--
-[]------[]-<>--
-[]------[]-[]--
XXXXXXXXXXXXXXXX
