----------------
----------------
----------------
----------------
----------------
----------------
----------------
----------------
----------------
----------------
----------------
---------E------
--------<>-----<
--------[]-----[
--E-----[]-----[
XXXXXXXXXXXXX--X
