----------------
----------------
----------------
----------------
----------------
----------------
---------XX-----
----------------
-------E--------
---XXXXXX-------
------------XXX-
----------------
XXXX------------
----------------
------------oo--
-----------XXX--
