----------------
----------------
----------------
----------------
SSSSSSSSSSSSSSSS
SSSSSSSSSSS-----
SSSSSSSSSSS-----
SSSSSSSSSSS-----
---------------<
---------------[
ooooooo--------[
SSSSSSS----XX--[
----------XXX--[
---------XXXX--[
---EE---XXXXX--[
XXXXXXXXXXXXXXXX
