X*************DX
X******X***X**DX
X***XXXXXXXXXXXX
X**XXXXXXXXXXXXX
XX*X************
XX*X************
X******X*******X
X*T************X
X**************X
X******X*******X
XXXXXXXX*******X
XXXX***XXXX****X
***************X
***********TT**X
***************X
***************X
