XXXX********XXXX
XXXXXX******XXXX
XXXX********XXXX
XXXX********XXXX
XX****TTTTTTTTXX
XX************XX
XX************XX
XTTTT***E*****XX
XMMMMMMMMMMMMMMM
****************
****E********E**
MMMMMMMMMMMMMMMM
****************
****************
*****TT*********
****************
