****************
**X*************
****************
*****X**X**X****
****************
****************
*************X**
*************X**
*************X**
**XTTX**X**X*X**
**X**X**X**X****
**X**X**X**X****
TTX**X**X**X****
****************
****************
XXXXXXXX********
