***********XX***
XXXX*******XXXXX
**XX***********X
**XXXXX********X
*****XX********X
*****XXXXX*****X
*********XX****X
*********XX****X
***************X
************XXXX
************XX**
*********XXXXX**
*********XX*****
******XXXXX*****
******XX********
***XXXXX********
