XX************XX
XX************XX
XTTTT***E*****XX
XXXX********XXXX
XXXX********XXXX
XXXXXXX*****XXXX
XXXX********XXXX
XX************XX
XX*****XXXX***XX
XX************XX
XXXX********XXXX
XXXXXX******XXXX
XXXX********XXXX
XXXX********XXXX
XX****TTTTTTTTXX
XX************XX
