----------------
----------------
----------------
----------------
----------------
----------------
----------------
----------------
----------------
----------------
----------------
--------------X-
--------E-----X-
-------<>---X-X-
-------[]---X-X-
XXXXXXXXXXX-X-X-
