----------------
----------------
----------------
----------------
----------------
----------------
----------------
----------------
----------------
----------------
--oo------------
----------------
----------------
----------------
------------E---
X----XXXXXXXXXXX
