----------------
----------------
----------------
----------------
----------------
----------------
----------------
----------------
----------------
------E---------
--E--<>---------
-<>--[]---------
-[]--[]---------
-[]--[]---------
-[]--[]--------E
-XX--XXXXXXXXXXX
