----------------
----------------
----------------
----------------
----------------
----------------
----------------
----------------
----------------
---------------E
-----------E--<>
-------E--<>--[]
------<>--[]--[]
------[]--[]--[]
EE-E--[]--[]--[]
XXXXX-XX--XX--XX
