----------------
----------------
----------------
----------------
----------------
----------------
----------------
----------------
----------------
----------------
-------------E--
---------E--<>--
--------<>--[]--
--------[]--[]--
--EE-E--[]--[]--
XXXXXXX-XX--XX--
