----------------
----------------
----------------
----------------
----------------
----------------
----------------
----------------
----------------
-------E--------
---E--<>--------
--<>--[]--------
--[]--[]--------
--[]--[]--------
--[]--[]--------
--XX--XXXXXXXXXX
