----------------
----------------
----------------
----------------
----------------
----------------
----------------
---------?------
----------------
----------------
----------------
SS----Q--Q--Q---
----------------
----------------
------E---------
XXXXXXXXXXXXXXXX
