----------------
----------------
----------------
----------------
----------------
----------------
----------------
----------------
----------------
----------------
oo------o----o--
----------------
----------------
----------------
----------------
XXXXXXX---XX---X
