----------------
----------------
----------------
----------------
----------------
----------------
----------------
----------------
----------------
-----------X----
----------XX--oo
---------XXX----
--------XXXX----
-------XXXXX----
---E--XXXXXX----
XXXXXXXXXXXXXXXX
