----------------
----------------
----------------
----------------
----------------
----------------
----------------
----------------
----------------
----------------
----------------
----------------
----------------
-----X----------
-EE--X----------
XXXXXXXXXXXXXXXX
