----------------
----------------
----------------
----------------
----------------
----------------
----------------
--------------Q-
----------------
----------------
----------------
--------Q---S?SQ
----------------
----------------
-------------E--
XXXXXXXXXXXXXXXX
