----------------
----------------
----------------
----------------
----------------
----------------
----------------
----SQQS--------
----------------
----------------
----------------
-----SS------X--
------------XX--
-----------XXX--
EE-E-E----XXXX--
XXXXXXXXXXXXXXXX
