----------------
----------------
----------------
----------------
----------------
----------------
----------------
----------------
----------------
----------E-----
------E--<>-----
--E--<>--[]-----
-<>--[]--[]-----
-[]--[]--[]-----
-[]--[]--[]-----
-XX--XX--XXXXXXX
