----------------
----------------
----------------
----------------
----------------
----------------
----------------
-----------XX---
-----------XX---
---------X-XX---
---------X-XX---
-------X-X-XX---
-E-----X-X-XX---
<>---X-X-X-XX---
[]---X-X-X-XX---
XXXX-X-X-X-XXXXX
