----------------
----------------
----------------
----------------
----------------
----------------
----------------
----------------
----------------
--------------X-
--------------X-
------------X-X-
------E-----X-X-
-----<>---X-X-X-
-----[]---X-X-X-
XXXXXXXXX-X-X-X-
