----------------
----------------
----------------
----------------
----------------
----------------
----------------
----------------
----------------
----------------
----------------
----SSQS--------
----------------
>--------------<
]---------EE---[
XXXXXXXXXXXXXXXX
