----------------
----------------
----------------
----------------
----------------
----------------
----------------
-?-----------SSS
----------------
----------------
----------------
-Q--Q-----S-----
----------------
----------------
----------------
XXXXXXXXXXXXXXXX
