----------------
----------------
----------------
----------------
----------------
----------------
----------------
----------------
----------------
----------------
----o-----------
----------------
----------------
-----------X---X
-----------X-E-X
-XX---XXXXXXXXXX
