----------------
----------------
----------------
----------------
----------------
----------------
----------------
----------------
----------------
----------------
----------------
--X----------XX-
--XX--------XXX-
--XXX------XXXX-
--XXXX----XXXXX-
XXXXXXXXXXXXXXX-
