----------------
----------------
----------------
----------------
----------------
----------------
----------------
----------------
----------------
----------------
--------------oo
----------------
----------------
-X--------------
-X--------------
XXXXXXXXXXXX----
