----------------
----------------
----------------
----------------
----------------
----------------
----------------
-------------XX-
------------XXX-
-----------XXXX-
----------XXXXX-
---------XXXXXX-
--------XXXXXXX-
----<>-XXXXXXXX-
E---[]XXXXXXXXX-
XXXXXXXXXXXXXXXX
