----------------
----------------
----------------
----------------
----------------
----------------
----------------
----------------
----------------
----------------
----------------
---------------E
--------------<>
--------------[]
-E------E-EE--[]
XXXXXXXXXXXXXXXX
