----------------
----------------
----------------
----------------
----------------
----------------
----------------
----------------
----------------
----------------
----oo----------
----------------
----------------
----------------
-------------EE-
XX------XXXXXXXX
