----------------
----------------
----------------
----------------
----------------
----------------
----------------
--------------SS
----------------
-------------E--
----------------
-----------S?S--
----------------
----------------
----------------
XXX--XXXXXXXXXXX
