----------------
----------------
----------------
----------------
----------------
----------------
----------------
----------------
----------------
-----E----------
-E--<>----------
<>--[]----------
[]--[]----------
[]--[]----------
[]--[]--------EE
XX--XXXXXXXXXXXX
