----------------
----------------
----------------
----------------
----------------
----------------
----------------
----------------
----------------
----------------
----------------
----------------
----------------
----------X-----
------EE--X-----
X-XXXXXXXXXXXXXX
