----------------
----------------
----------------
----------------
----------------
----------------
----------------
----------------
----------------
----------------
----------------
-E--------------
<>----------E---
[]---------<>---
[]---------[]---
XXXXXXXXXXXXXXX-
