----------------
----------------
----------------
----------------
----------------
----------------
----------------
----------------
----------------
----------------
--o----o--------
----------------
----------------
--------------X-
--------------X-
X---XX---XXXXXXX
