*********D******
*********D******
********TTTT****
****************
**TTTTTTTT******
****************
****************
TTTT************
****************
****************
******TTT*******
*********#######
****************
******####******
****************
***TTTT*********
