****************
****************
****TTTT********
**********TTT***
*********D******
*********D******
********TTTT****
****************
**TTTTTTTT******
****************
****************
TTTT************
****************
****************
******TTT*******
*********#######
