***TTTT*********
**************H*
####********####
****************
********DTTTT***
********D*******
******####******
****************
***####*********
****************
****************
#######*********
****************
******TTTT******
****************
*********####***
