MMMMMMMMMMMMMMM#
****************
**H********H****
MMMMMMMMMMMMMMMM
****************
****************
####****########
####********####
####********####
#TTTTTTTT***####
####********####
####********####
####*****TTTT###
####********####
####********####
####**##########
