****####**####**
****####**####**
****#TTTT*####**
**********####**
**********####**
*********TTT##**
*******H********
MMMMMMMMMMMMMMMM
**************#*
************TTTT
**************#*
****************
*********#******
*********#******
*****H***#***H**
MMMMMMMMM#MMMMMM
