#TTTTTTTT***####
####********####
####********####
####*****TTTT###
####********####
####********####
####**##########
####********####
####********####
##TTTT******####
####********D###
####********D###
####****########
####********####
####********####
#TTTTTTTT***####
