****************
****************
******TTT*******
*********#######
****************
******####******
****************
***TTTT*********
**************H*
####********####
****************
*********TTTT***
****************
******####******
****************
***####*********
