****************
*********####***
****************
****************
*********#######
****************
******####******
****************
***TTTT*********
**************H*
####********####
****************
********DTTTT***
********D*******
******####******
****************
