####********####
***####**TTT****
***###D***####**
*TTT##D***####**
***#####**####**
****####**####**
****####**####**
****####*TTTTTTT
****####**####**
****####**####**
****#TTTT*####**
**********####**
**********####**
*********TTT##**
*******H********
MMMMMMMMMMMMMMMM
