----TTTTTTTT----
TTT-------------
----------------
----------------
----TTTT--------
----------TTT---
---------D------
---------D------
--------TTTT----
----------------
--TTTTTTTT------
----------------
----------------
TTTT------------
----------------
----------------
