-----H----------
----TTT---------
----------------
------####------
----------------
---------####---
----------------
----------------
#MMMMMMMMMMMMMMM
----------------
----H--------H--
MMMMMMMMMMMMMMMM
----------------
----------------
-----TT---------
----------------
