--------------H-
####--------####
----------------
--------DTTTT---
--------D-------
------####------
----------------
---####---------
----------------
----------------
#######---------
----------------
------TTTT------
----------------
---------####---
----------------
