####--------####
####--------####
#TTTTTTTT---####
####--------####
####--------####
####-----TTTT###
####--------####
####--------####
####--##########
####--------####
####--------####
##TTTT------####
####--------####
####--------####
---####--TTT----
---###D---####--
