---------D------
--------TTTT----
----------------
--TTTTTTTT------
----------------
----------------
TTTT------------
----------------
----------------
------TTT-------
---------#######
----------------
------####------
----------------
---TTTT---------
--------------H-
