------TTTT------
----------------
---------####---
----------------
####--------####
-----H----------
----TTT---------
----------------
------####------
----------------
---------####---
----------------
----------------
#MMMMMMMMMMMMMMM
----------------
----H--------H--
