----------------
----------------
-----TT---------
----------------
---H-----H------
MMMMMMMMMMMMMMM#
----------------
--H--------H----
MMMMMMMMMMMMMMMM
----------------
----------------
####----########
####--------####
####--------####
#TTTTTTTT---####
####--------####
