----------------
-----TT---------
----------------
---H-----H------
MMMMMMMMMMMMMMM#
----------------
--H--------H----
MMMMMMMMMMMMMMMM
----------------
----------------
#MMMMMMMMMMMMMMM
----------------
----H--------H--
MMMMMMMMMMMMMMMM
----------------
----------------
