----------------
---#------------
---#------------
-H-#---H--------
MMM#MMMMMMMMMMMM
----------------
----------------
---------TTT----
----------------
#-----------TTTT
#--------------#
#--------------#
#########------#
##-------------#
##--------TTTTTT
#D-------------#
