####--##########
####--------####
####--------####
##TTTT------####
####--------####
####--------####
---####--TTT----
---###D---####--
-TTT##D---####--
---#####--####--
----####--####--
----####--####--
----####-TTTTTTT
----####--####--
----####--####--
----#TTTT-####--
