----------------
---------#------
---------#------
-----H---#---H--
MMMMMMMMM#MMMMMM
----------------
----------------
---#------------
---#------------
-H-#---H--------
MMM#MMMMMMMMMMMM
----------------
--------------#-
------------TTTT
--------------#-
----------------
