--H--------H----
MMMMMMMMMMMMMMMM
----------------
----------------
####----########
####--------####
####--------####
#TTTTTTTT---####
####--------####
####--------####
####-----TTTT###
####--------####
####--------####
####--##########
####--------####
####--------####
