---------TTTT---
----------------
------####------
----------------
---####---------
----------------
----------------
#######---------
----------------
------TTTT------
----------------
---------####---
----------------
####--------####
-----H----------
----TTT---------
