----------------
----------------
----------------
----------------
----------------
----------------
----------------
----------------
----------------
----------------
----------------
-------------Q--
----------------
----------------
----------------
XXXXXXXXXXXXXXXX
