----------------
----------------
----------------
----------------
----------------
----------------
---------------E
-------------SSS
----------------
------------E---
----------------
----------S?S---
----------------
----------------
----------------
XX--XXXXXXXXXXXX
