----------------
----------------
----------------
----------------
----------------
----------------
----------------
----------------
----------------
----------------
-------------S--
------<>--------
------[]--------
------[]--------
--E-E-[]--------
XXXXXXXXXXXXXXXX
