----------------
----------------
----------------
----------------
----------------
----------------
----------------
----------------
----------------
----------------
----------------
---XX--X--------
--XXX--XX-------
-XXXX--XXX-----<
XXXXX--XXXX----[
XXXXX--XXXXXXXXX
