----------------
----------------
----------------
----------------
----------------
----------------
----------------
---XX-----------
--XXX-----------
-XXXX-----------
XXXXX-----------
XXXXX-----------
XXXXX-----------
XXXXX-----------
XXXXX--------X--
XXXXXXXXXXXXXXXX
