----------------
----------------
----------------
----------------
----------------
----------------
-----E----------
---SSSSSSSS---SS
----------------
--E-------------
----------------
S?S-------------
----------------
----------------
----------------
XXXXXXXXX---XXXX
