----------------
----------------
----------------
----------------
----------------
----------------
----------------
----------------
----------------
----------------
----------------
-----------Q---S
----------------
----------------
----------------
XXXXXXXXXXXXXXXX
