----------------
----------------
----------------
----------------
----------------
----------------
----------------
----------------
----------------
----------------
----------------
-----------SSQS-
----------------
X-----<>--------
XX----[]--------
XXXXXXXXXXXXXXXX
