----------------
----------------
----------------
----------------
----------------
----------------
----------------
----------------
----------------
----------------
-------S--------
<>--------------
[]--------------
[]--------------
[]--------------
XXXXXXXXXXXX--XX
