---------------X
-----------TT--X
---------------X
---------------X
-------------TTX
---------------X
------XXXXXXXXXX
------XX--------
------XX--------
XXXXXXXX----XXXX
----------------
----------------
--------XXXX----
--------XXXX----
------XXXXXX----
----------------
