----------------
--------T-------
----------------
--------T-------
----------------
----------------
X-----TTTT-TTTTT
X---------------
X---------------
X----------DX---
X----------DX--X
X-----XXXXXXXX-X
X-----XX-------X
X--XXXXX-------X
X--X------XXXXXX
X--X----------XX
