X--X----------XX
X--X---XXXXXXXXX
--TX---XX-------
---X---XX-------
---X-TTXX-------
XXXX---XX-----XX
XXXX---XX---TTXX
XXXXTT-XX-----XX
XXXX---XX-----XX
------T---TT----
----------------
----------------
-----TTTTT------
----------------
----------------
---TTTT--TTTT---
