X--X-----------X
XT-X-----------X
X--XXXXX-------X
X--X-----------X
X-TX-----XXXX--X
X--X-----------X
X--X----------XX
XT-X----------XX
X--X----------XX
X--X---XXXXXXXXX
--TX---XX-------
---X---XX-------
---X-TTXX-------
XXXX---XX-----XX
XXXX---XX---TTXX
XXXXTT-XX-----XX
