---XX-----------
XXXX----------XX
XXXX----------DX
XXXX----------DX
XXXX----XXXXXXXX
---X-X----------
---X------------
XXX-----------XX
XXXXXXXXXX----XX
XX------------XX
XX------------XX
XX----XXXXXXXXXX
XX------------XX
XX------------XX
XXXXXXXX------XX
XX----XXXXX---XX
