------XXXXX-----
------XX--------
---XXXXX--------
---XX-----------
---XX-----------
XXXX----------XX
XXXX----------DX
XXXX----------DX
XXXX----XXXXXXXX
---X-X----------
---X------------
XXX-----------XX
XXXXXXXXXX----XX
XX------------XX
XX------------XX
XX----XXXXXXXXXX
