----------------
----------------
--------XXXX----
--------XXXX----
------XXXXXX----
----------------
---XXXX---------
---XX-----------
XXXXX-----XXXXXX
----------XX----
-------XXXXX----
----------------
----TTTT--------
----------------
----------------
--X-------------
