---------XX----X
---------XX----X
---------------X
------------XXXX
------------XX--
---------XXXXX--
---------XX-----
------XXXXX-----
------XX--------
---XXXXX--------
---XX-----------
---XX-----------
XXXX----------XX
XXXX----------DX
XXXX----------DX
XXXX----XXXXXXXX
