X---------------
X----------DX---
X----------DX--X
X-----XXXXXXXX-X
X-----XX-------X
X--XXXXX-------X
X--X------XXXXXX
X--X----------XX
XT-X----------XX
X--X-XXXX-----XX
X--X----------XX
X-TX----------XX
X--X-----XXXX-XX
X--X----------XX
XT-X----------XX
X--DXXXX------XX
