-----TT--TT-----
----------------
----------------
--XX------------
--XXXXX---------
-----XX---------
-----XXXXX------
--------XX------
--------XXXXX---
-----------XX---
XXXX-------XXXXX
--XX-----------X
--XXXXX--------X
-----XX--------X
-----XXXXX-----X
---------XX----X
