-------------X--
--XTTX--X--X-X--
--X--X--X--X----
--X--X--X--X----
TTX--X--X--X----
----------------
----------------
XXXXXXXX--------
----------------
--------T-------
----------------
--------T-------
----------------
----------------
X-----TTTT-TTTTT
X---------------
