----------XX----
-------XXXXX----
----------------
----TTTT--------
----------------
----------------
--X-------------
----------------
-----X--X--X----
----------------
----------------
-------------X--
-------------X--
-------------X--
--XTTX--X--X-X--
--X--X--X--X----
