-------TT--TTTT-
----------------
----------------
-----TT--TT-----
----------------
----------------
------T---TT----
----------------
----------------
-----TTTTT------
----------------
----------------
---TTTT--TTTT---
----------------
----------------
-------TT--TTTT-
