XT-X----------XX
X--X-XXXX-----XX
X--X----------XX
X-TX----------XX
X--X-----XXXX-XX
X--X----------XX
XT-X----------XX
X--DXXXX------XX
X--D----------XX
X-TX-----------X
X--X----XXXX---X
X--X-----------X
XT-X-----------X
X--XXXXX-------X
X--X-----------X
X-TX-----XXXX--X
