----------------
----------------
----------------
----------------
----------------
----------------
----------------
----------------
----------------
----------------
----------------
-XX--X----------
XXX--XX---------
XXX--XXX-----<>-
XXX--XXXX----[]-
XXX--XXXXXXXXXXX
