----------------
----------------
----------------
----------------
----------------
----------------
----------------
----------------
----------------
----------------
---------S------
--<>------------
--[]------------
--[]------------
E-[]------------
XXXXXXXXXXXXXX--
