----------------
----------------
----------------
----------------
----------------
----------------
----------------
----------------
----------------
----------------
----------------
------------Q---
----------------
----------------
----------------
XXXXXXXXXXXXXXXX
