----------------
----------------
----------------
----------------
----------------
----------------
------------E---
----------SSSSSS
----------------
---------E------
----------------
-------S?S------
----------------
----------------
----------------
-XXXXXXXXXXXXXXX
