----------------
----------------
----------------
----------------
----------------
----------------
----------------
----------------
----------------
----------------
----------------
------SSQS------
----------------
-<>-------------
-[]---------EE--
XXXXXXXXXXXXXXXX
