***********XXXXX
*******XXXXXXXXX
******TTTTTTTTTT
****XX**********
****XX**********
****XX**********
XXXXXX*******XXX
************XX**
******XXXX**XX**
************XX**
************XX**
**********XXXX**
****************
***E***E********
MMMMMMMMMMMMMMMM
****************
