XX**************
****************
*****TTTT*******
****************
****************
********TTTT****
****************
**************T*
****************
****************
*****X***X***X**
**X**X***X***X**
**X**X***X***X**
**X**X***X***X**
**X*T***********
****************
