******TTTT******
****************
***TTTT*********
****************
****************
TTTT******TTTTTT
X***************
X***************
X******TTTT*****
X***************
XX**************
XD**TTTT********
XD**************
XTTTT***********
****************
***TTTT*********
