XX**********XXXX
XX****TTXXXXXXXX
XX**************
XX**************
XXTTTT**********
XX**************
****************
*****TTTT*******
****************
****************
********TTTT****
****************
**************T*
****************
****************
*****X***X***X**
