******TTTTTTTT**
****************
***DXXX**TTT****
***DXXX***XXXX**
*TTTXXX***XXXX**
***XXXXX**XXXX**
****XXXX**XXXX**
****XXXX**XXXX**
****XXXX*TTTTTTT
****XXXX**XXXX**
****XXXX**XXXX**
****XTTTT*XXXX**
**********XXXX**
**********XXXX**
*********TTTXX**
*******E********
