X***XXXX******DX
X***XXXXXXXX**DX
XX******XXXXXXXX
XX**********XXXX
XX***********XXX
XXXXXXXXXX***XXX
XXXX***********X
XXXX***********X
*********XXXX**X
XX*******XX***XX
XX****XXXXX***X*
XX************X*
XXXXX*********X*
**************XX
***XXXX*******XX
*****XX*******XX
