X************XXX
X**T*********XXX
****************
****************
*T**************
****************
****T***XX******
********XD******
********XD******
********XXXXX***
TTTT********XXXX
****************
****************
***XXXXXX*******
****************
********TTTT****
