*TTTT***********
****************
****************
*******TT*******
****************
****************
***********TTTT*
****************
****************
*TTTTTTTT*******
****************
****************
XXXX********XXXX
XXXX********XXXX
XXXXXXX*****XXXX
XXXX********XXXX
