****************
*****TTTT*******
****************
****T****TTTT***
****************
****************
**TTTT*****TTTT*
********D*******
********D*******
******TTTT******
****************
****************
**TTTT****TTTT**
****************
****************
TTTT*******TTTTT
