XXXX******XXXX**
XX***********XXX
XX**TT*******XXX
XX***********XXX
XX***********XXX
*XXXXXXXE**XXXX*
*XXXX******XXXX*
*XXXX******XXXX*
*XXXX****EXXXXX*
****************
****************
*******XXXXXXXX*
*XXXX***********
****************
****************
****XXXX********
