XXXX***********X
*********XXXX**X
XX*******XX***XX
XX****XXXXX***X*
XX************X*
XXXXX*********X*
**************XX
***XXXX*******XX
*****XX*******XX
*****XXXXX****XX
****************
****************
*********XXXX***
****************
XXXXXXXX****XXXX
************XXXX
