************XXXX
****************
********TTT*****
****************
****************
TTT*********XXXX
****************
************TTTT
XXXX************
****************
**TTTTTTTT******
****************
****************
************XXXX
XXXX************
**********TTTTTT
