***X************
****************
XXEEEEEEX**XEEEX
*XXXXXXXX**XXXXX
*********T*****X
***************X
****************
**********T*****
****************
****************
XX**********XXXX
XX**********XXXX
XXXXXXXXE***XXXX
XXXX******XXXXXX
XXXX******XXXX**
XXXXE*EXXXXXXX**
