****XXXX**XXXX**
****XXXX*TTTTTTT
****XXXX**XXXX**
****XXXX**XXXX**
****XTTTT*XXXX**
**********XXXX**
**********XXXX**
*********TTTXX**
*******E********
****************
***XXXX**TTT****
***XXXX***XXXX**
*TTTXXX***XXXX**
***XXXXX**XXXX**
****XXXX**XXXX**
****XXXX**XXXX**
