X*************XX
X*************DX
X*************DX
X*****XXXXXXXXXX
X**XXXX*********
X***************
X***************
XXXXX***********
**XX************
**XXXXX*********
*****XX*********
*****XXXXX******
********XX******
********XXXXX***
***********XX***
XXXX*******XXXXX
