**********XXXX**
*********TTTXX**
*******E********
MMMMMMMMMMMMMMMM
**************X*
************TTTT
**************X*
****************
*********X******
*********X******
*****E***X***E**
MMMMMMMMMXMMMMMM
****************
****************
***X************
***X************
