XXXX********DXXX
XXXX****XXXXXXXX
XXXX********XXXX
XXXX********XXXX
XTTTTTTTT***XXXX
XXXX********XXXX
XXXX********XXXX
XXXX*****TTTTXXX
XXXX********XXXX
XXXX********XXXX
XXXX**XXXXXXXXXX
XXXX********XXXX
XXXX********XXXX
XXTTTT******XXXX
XXXX********XXXX
XXXX********XXXX
