XXXX********XXXX
****************
****************
*****TTTT*******
****************
XXXX********XXXX
************XXXX
***********XXXXX
*******XXXXXXXXX
******TTTTTTTTTT
****************
****************
****TTTT********
**********TTT***
****************
****************
