XXXX******XXXX**
XX***********XXX
XX**TT*******XXX
XX***********XXX
XX***********XXX
*XXXXXXXE**XXXX*
*XXXX******XXXX*
*XXXX******XXXX*
*XXXX****EXXXXX*
XX**********XXXX
XX**********XXXX
XXXXXXXXE***XXXX
XXXX******XXXXXX
XXXX******XXXX**
XXXXE*EXXXXXXX**
XXXX******XXXX**
