*********TTTT***
****************
XXXX********XXXX
****************
****************
*****TTTT*******
****************
XXXX********XXXX
************XXXX
***********XXXXX
*******XXXXXXXXX
******TTTTTTTTTT
****XX**********
****XX**********
****XX**********
XXXXXX*******XXX
