****TTT*********
****************
******XXXX******
****************
*********XXXX***
****************
****************
MMMMMMMMMMMMMMMM
****************
****************
*TTTT***********
****************
****************
*******TT*******
****************
****************
