*****XX*******XX
*****XXXXX****XX
****************
****************
*********XXXX***
****************
XXXXXXXX****XXXX
************XXXX
************XXXX
******XXXXXXXXXX
******DX********
******DX********
XXXXXXXX****XXXX
****************
*********XXXX***
****************
