****************
***TTTT**TTTT***
****************
****************
*******TT**TTTT*
****************
****************
*****TT**TT*****
****************
****************
******T***TT****
****************
****************
*****TTTTT******
****************
****************
