***TTTT**TTTT***
****************
****************
*******TT**TTTT*
****************
****************
*****TT**TT*****
****************
****************
**XX************
**XXXXX*********
*****XX*********
*****XXXXX******
********XX******
********XXXXX***
***********XX***
