X***EXXD******XX
X****XXD******XX
X**TT**XXXXXX**X
X******XXXX****X
XX*****XXXX**T*X
XXE****XXXX****X
XX****XX*******X
XXTT**XX*****T*X
******XX*******X
*****TXX*******X
*******X****TT**
***TT**X********
*******X********
************T***
****TT***TT*****
****************
