********X*T*****
****************
****************
MMMMMMMMXMMMMMMM
****************
****************
XXXX**********XX
XXXX**********XX
XXXX**********XX
XXXX******XXXXXX
****************
****************
MMMMMMMMMMMMMMMM
****************
*X**************
XX**********XXXX
