XXE****XXXX****X
XX****XX*******X
XXTT**XX*****T*X
******XX*******X
*****TXX*******X
*******X****TT**
***TT**X********
*******X********
************T***
****TT***TT*****
****************
****************
*****TTTTTTT****
****************
****************
***TTTT**TTTT***
