**********XXXX**
*********TTTXX**
*******E********
****************
*********XXXXXXX
****************
******XXXX******
****************
***TTTT*********
**************E*
XXXX********XXXX
****************
*********TTTT***
****************
******XXXX******
****************
