****************
******TTTT******
****************
*********XXXX***
****************
XXXX********XXXX
*****E**********
****TTT*********
****************
******XXXX******
****************
*********XXXX***
****************
****************
MMMMMMMMMMMMMMMM
****************
