****XXXX**XXXX**
****XTTTT*XXXX**
**********XXXX**
**********XXXX**
*********TTTXX**
*******E********
MMMMMMMMMMMMMMMM
****************
****************
TTTTTTTT********
*********TTTT***
****************
XXXX********XXXX
****************
****************
*****TTTT*******
