****************
***XXXX*********
***XX***********
XXXXX*****XXXXXX
**********XX****
*******XXXXX****
****************
****TTTT********
****************
****************
**X*************
****************
*****X**X**X****
****************
****************
*************X**
