X******TTTT*****
X***************
XX**************
XD**TTTT********
XD**************
XTTTT***********
****************
***TTTT*********
****************
******TTTT******
****************
*********TTTT***
****************
XXXX********TTTT
****************
***TTTT*********
