X********T******
****************
****************
****XXXXXXXX****
***********X****
***********X****
XX**********XXXX
XX**************
XX**************
XXXXMMMMMMMMMMMM
XXXX************
XXXX************
XXXX****X*******
********X*******
********X*******
********X*T*****
