**TTTTTTTT******
****************
****************
TTTT************
****************
****************
******TTT*******
****************
*********TTT****
****************
X***********TTTT
X**************X
X**************X
XXXXXXXXX******X
XX*************X
XX********TTTTTT
