XX***********XXX
*XXXXXXXE**XXXX*
*XXXX******XXXX*
*XXXX******XXXX*
*XXXX****EXXXXX*
****************
****************
*******XXXXXXXX*
*XXXX***********
****************
****************
****XXXX********
****************
XXXX**********XX
**************XX
**************XX
