****************
********TTTT****
****************
****************
*****T**********
****************
****************
****TTTT********
****************
********TTTT****
X*************XX
X*************DX
X*************DX
X*****XXXXXXXXXX
X**XXXX*********
X***************
