XXXXMMMMMMMMMMXX
X*************XX
X*************XX
XMMMMMMMMMMMMMXX
XX**************
XX**************
XXXX********XXXX
XXXX********XXXX
XXXXXXX*****XXXX
XXXX******T*XXXX
XX**********XXXX
XX**********XXXX
XX****TTXXXXXXXX
XX**************
XX**************
XXTTTT**********
