****************
********TTTTTTTT
****************
****************
TTTTTTTT********
*********TTTT***
****************
XXXX********XXXX
****************
****************
*****TTTT*******
****************
XXXX********XXXX
************XXXX
***********XXXXX
*******XXXXXXXXX
