XMMMMMMMMMMMMMMM
****************
****E********E**
MMMMMMMMMMMMMMMM
****************
****************
*****TT*********
****************
***E*****E******
MMMMMMMMMMMMMMMX
****************
**E********E****
MMMMMMMMMMMMMMMM
****************
****************
XXXX****XXXXXXXX
