****************
******XXXX******
******XX********
***XXXXX********
***XX***********
XXXXX*********XX
X*************XX
X*************XX
XXXE*******EXXXX
XMMMMMMMMMMMMMXX
X**************X
X**************X
X***XXXX*******X
X**************X
****************
XMMMMMMMMMMMMMMX
