*********XXXXXXX
****************
*******XXXX*****
***XEEE*********
***DXXX*********
***D************
XXXX*********XXX
****************
***********XXXX*
*******XEEE*****
*******XXXX*****
****XEEE********
XXXXXXXX*******X
***************X
***************X
*************XXX
