**********XXXX**
****************
***E***E********
MMMMMMMMMMMMMMMM
****************
****************
*******TT*******
*********X******
****************
*****X**********
***********X****
****************
****************
*************X**
****************
****************
