***************X
*XXXX********XXX
TT**********XXXX
****************
******XXXX******
TTTTTTTT********
****************
************XXXX
****************
********TTTTTTTT
****************
****************
TTTTTTTT********
*********TTTT***
****************
XXXX********XXXX
