XMMMMMMMMMMMMMMX
X**************X
X****X*********X
X**************X
****************
***X************
****************
XXEEEEEEX**XEEEX
*XXXXXXXX**XXXXX
*********T*****X
***************X
****************
**********T*****
****************
****************
XX**********XXXX
