**X**X***X***X**
**X*T***********
****************
****************
****TTTTT*******
****************
****************
******TTTT******
****************
***TTTT*********
****************
****************
TTTT******TTTTTT
X***************
X***************
X******TTTT*****
