*E*X***E********
MMMXMMMMMMMMMMMM
****************
****************
*********TTT****
****************
X***********TTTT
X**************X
X**************X
XXXXXXXXX******X
XX*************X
XX********TTTTTT
XD*************X
XD*************X
TTTTXXXXXXXX***X
**TTTTTTTT*****X
