******XXXXXXXXXX
******XX********
******XX********
XXXXXXXX****XXXX
****************
****************
********XXXX****
********XXXX****
******XXXXXX****
****************
***XXXX*********
***XX***********
XXXXX*****XXXXXX
**********XX****
*******XXXXX****
****************
