***********XXXX*
*******XEEE*****
*******XXXX*****
****XEEE********
XXXXXXXX*******X
***************X
***************X
*************XXX
*************XXX
***********T*XXX
*******XEEEEEEXX
*****T*XXXXXX*X*
****************
****************
XXXX************
XXXX************
