****************
TTTT*******TTTTT
****************
****************
***TTTT*********
****************
****************
XX*****TTTT***XX
XX************XX
XX************XX
XXXXXX****XXXXXX
XX************XX
XX************XX
X*****TTTT*****X
*********TTTT***
****************
