****************
*TTTTTTTT*******
****************
****************
XXXX********XXXX
XXXX********XXXX
XXXXXXX*****XXXX
XXXX********XXXX
XX************XX
XX*****XXXX***DX
XX************DX
XXXX********XXXX
XXXXXX******XXXX
XXXX********XXXX
XXXX********XXXX
XX****TTTTTTTTXX
