*****XX********X
*****XXXXX*****X
*********XX****X
*********XX****X
***************X
X***********XXXX
X***XXXXXXXXXXXX
X*************XX
X*************XX
XXXX**********XX
XXXXXXXX******XX
XXXXXXXXXXXX**XX
XX************XX
XX***********XXX
XD***********XXX
XD***********XXX
