*************XXX
XTTTTTTTT****XXX
X*****XXXX*XXXXX
X************XXX
X*************XX
X*************XX
X*************DX
X*************DX
X*****XXXXXXXXXX
********TTTTTTTT
****TTTTTTTT****
TTT*************
****************
****************
****TTTT********
**********TTT***
