********TTTT****
****************
**TTTTTTTT******
****************
****************
TTTT************
****************
****************
******TTT*******
***XXXX**TTT****
***XXXX***XXXX**
*TTTXXX***XXXX**
***XXXXX**XXXX**
****XXXX**XXXX**
****XXXX**XXXX**
****XXXX*TTTTTTT
