XXXX********TTTT
****************
***TTTT*********
****************
******XXXX******
****************
*********TTTT***
****************
****************
XTTTTTTTT****XXX
X************XXX
X************XXX
X**T*********XXX
****************
****************
*T**************
