***XXXD***XXXX**
*TTTXXD***XXXX**
***XXXXX**XXXX**
****XXXX**XXXX**
****XXXX**XXXX**
****XXXX*TTTTTTT
****XXXX**XXXX**
****XXXX**XXXX**
****XTTTT*XXXX**
**********XXXX**
**********XXXX**
*********TTTXX**
*******E********
MMMMMMMMMMMMMMMM
**************X*
************TTTT
