XX**************
XX**************
XXXXMMMMMMMMMMMM
XXXX************
XXXX************
XXXX****X*******
********X*******
********X*******
********X*T*****
****************
****************
MMMMMMMMXMMMMMMM
****************
****************
XXXX**********XX
XXXX**********XX
