XTTTT***********
****************
***TTTT*********
****************
******TTTT******
****************
*********TTTT***
****************
XXXX********TTTT
****************
***TTTT*********
****************
******XXXX******
****************
*********TTTT***
****************
