****TTT*********
****************
******XXXX******
****************
*********XXXX***
****************
****************
XMMMMMMMMMMMMMMM
****************
****E********E**
MMMMMMMMMMMMMMMM
****************
****************
*****TT*********
****************
***E*****E******
