X**************X
****************
XMMMMMMMMMMMMMMX
X**************X
XE***********EXX
XMMMMMMMMMMMMMMX
****************
****************
XMMMMMMMMMMMMMMX
X**************X
X****X*********X
X**************X
****************
***X************
****************
XXEEEEEEX**XEEEX
