XXXX**********XX
XXXX******XXXXXX
****************
****************
MMMMMMMMMMMMMMMM
****************
*X**************
XX**********XXXX
XX**************
XX**************
XXMMMMMMMMMMMMMM
**********XX****
**********XX****
**TTTT**********
****************
****************
