********TTTT****
****************
X*************XX
X*************XX
XXXE*******EXXXX
XMMMMMMMMMMMMMXX
X**************X
X**************X
X***XXXX*******X
X**************X
****************
XMMMMMMMMMMMMMMX
X**************X
XE***********EXX
XMMMMMMMMMMMMMMX
****************
