X****XX*******XX
XTT**XX****XXXXX
X***EXX*******XX
X****XX*******XX
X**TT**XXXXXX**X
X******XXXX****X
XX*****XXXX**T*X
XXE****XXXX****X
XX****XX*******X
XXTT**XX*****T*X
******XX*******X
*****TXX*******X
*******X****TT**
***TT**X********
*******X********
X****XX*******XX
