XXXX*****XXXX***
XXXX********XXXX
XXXX*T******XXXX
X***********DXXX
X***********DXXX
X***T**XXXXXXXXX
X**************X
X**************X
XXXXXXXXX******X
XXXX************
X********T******
****************
****************
****XXXXXXXX****
***********X****
***********X****
