X*****TTTT*****X
*********TTTT***
****************
****************
XD***********TXX
XD************XX
XXTTTXXXX*****XX
XX************XX
****************
*********TTTT***
****************
****************
XX******TTTTTTXX
XX************XX
XX************XX
XXXX**********XX
