XXXX************
XXXXEEEX********
XXXXXX*XX*******
****************
****************
********TTTT****
****************
****************
*****T**********
****************
****************
****TTTT********
****************
********TTTT****
X*************XX
X*************DX
