****************
****************
*******X***X****
****************
****X***********
****************
****************
***X************
*TTTT***********
****************
****************
XXXX************
XXXX************
XXXX**TTTT******
XXXX************
XX*************X
