******XXXX******
****************
***TTTT*********
**************E*
XXXX********XXXX
****************
********DTTTT***
********D*******
******XXXX******
****************
***XXXX*********
****************
****************
XXXXXXX*********
****************
******TTTT******
