XXXXXXXX****XXXX
************XXXX
************XXXX
******XXXXXXXXXX
******DX********
******DX********
XXXXXXXX****XXXX
****************
*********XXXX***
****************
******XXXX******
******XX********
***XXXXX********
***XX***********
XXXXX*********XX
X*************XX
